chapitre	chapter
20	20
la	the
requête	query
de	of
lord	lord
voldemort	voldemort
harry	harry
et	and
ron	ron
quittèrent	left
l'infirmerie	the infirmary
le	the
lundi	Monday
suivant	following
en	in
pleine	full
forme	form
grâce	thanks
aux	the
bons	good
soins	care
mrs	mrs
pomfresh	pomfresh
maintenant	now
capable	able
d'apprécier	enjoy
les	the
avantages	benefits
fracture	fracture
l'empoisonnement	poisoning
plus	more
grand	great
ces	these
était	was
réconciliation	reconciliation
hermione	hermione
elle-même	itself
avait	had
accompagnés	accompanied
bas	the bottom
pour	for
déjeuner	breakfast
apportant	bringing
avec	with
elle	it
nouvelle	new
que	that
ginny	ginny
s'était	had
disputée	disputed
dean	dean
monstre	monster
tapi	tapi
dans	in
poitrine	chest
leva	rose
soudainement	suddenly
tête	head
sentant	feeling
un	a
vent	wind
d'espoir	hope
"À	"
propos	about
"	"
demanda-t-il	he asked
essayant	trying
d'en	to
savoir	know
alors	then
qu'ils	they
tournaient	turned
couloir	hallway
du	the
septième	seventh
étage	floor
complètement	completely
vide	empty
mis	put
à	to
part	share
une	a
petite	small
fille	girl
qui	that
examinait	examined
tapisserie	tapestry
trolls	trolls
tutus	tutus
semblait	seemed
terrifiée	terrified
vue	view
des	of
sixièmes	sixth
années	years
s'approchait	approaching
laissa	let
tomber	fall
lourds	heavy
poids	weight
laiton	brass
qu'elle	it
portait	wore
"Ça	"It
va	will
aller	go
dit	said
gentiment	kindly
se	is
précipitant	precipitating
l'aider	the help
"ici	"here
frappa	hit
cassés	broken
sa	its
baguette	wand
prononça	spoke
"reparo	"reparo
ne	do
remercia	thanked
pas	not
mais	but
bougea	moved
observa	watched
pendant	during
s'éloignaient	go
lui	him
jeta	threw
coup	blow
d'œil	eye
arrière	rear
"je	"I
te	te
jure	swear
s'indigna-t-il	grew indignant-t-he
t'occupe	never mind
d'elle	it
peu	little
impatient	looking forward
"pourquoi	"why
sont-ils	are they
disputés	played
"oh	"oh
a	has
ri	ri
quand	when
mclaggen	mclaggen
t'a	you
frappé	hit
batte	bat
"répondit	"answered
pouvait	could
sembler	seem
drôle	funny
raisonnablement	reasonably
n'était	there was
tous	all
s'échauffa	if overheated
"c'était	"it was
terrible	terrible
si	if
coote	coote
peakes	peakes
n'avaient	had
attrapé	caught
il	it
aurait	would
pu	could
blesser	hurt
très	very
gravement	seriously
ouais	yeah
bien	well
n'y	there
besoin	need
séparent	separate
sondant	probing
encore	yet
terrain	field
"ou	"or
toujours	always
ensembles	sets
"oui	"yes
ils	they
sont	are
pourquoi	why
es-tu	are you
intéressé	interested
demanda	asked
lançant	launching
regard	look
insistant	insisting
"c'est	"it is
seulement	only
je	I
veux	want to
mon	my
équipe	team
quidditch	quidditch
soit	either
gâchée	wasted
nouveau	new
répliqua-t-il	he replied
continuait	continued
être	be
soupçonneuse	suspicious
fut	was
soulagé	relieved
voix	voice
derrière	behind
eux	them
l'appela	the called
"harry	"harry
donnant	giving
excuse	excuse
tourner	turn
dos	back
salut	hi
luna	luna
suis	am
allé	gone
voir"	see"
fouillant	searching
son	its
sac	bag
"mais	"but
ont	have
tu	you
étais	was
sorti…"	out..."
déposa	filed
ce	this
ressemblait	looked like
oignon	onion
vert	green
crapaud	toad
tâché	tried
quantité	quantity
considérable	considerable
litière	litter
chat	cat
mains	hands
extirpant	free
finalement	finally
rouleau	roll
parchemin	parchment
plutôt	rather
sale	dirty
remit	gave
c'était	it was
donner	give
ça	it
petit	small
identifia	identified
immédiatement	immediately
comme	as
invitation	invitation
autre	other
leçon	lesson
dumbledore	dumbledore
"ce	"this
soir	evening
fois	time
qu'il	it
l'eut	had
déroulé	place
"très	"very
commentaires	comments
dernier	last
match	match
reprenait	included
l'oignon	the onion
sourit	smiles
vaguement	vaguely
"tu	"you
moques	fun
moi	me
n'est-ce	is this
tout	all
monde	world
j'ai	I
été	been
épouvantable	terrible
"non	"not
sérieux	serious
assura	assura
sincèrement	sincerely
peux	can
me	me
souvenir	remember
plaisants	pleasant
qu'est-ce	what is this
c'est	it is
ajouta-t-il	he added
levant	rising
hauteur	height
œil	eye
gurdyroot	gurdyroot
garder	keep
l'aimes	love it
j'en	I
ai	I
d'autres	other
vraiment	really
excellents	excellent
protéger	protect
plimpies	plimpies
s'en	in
alla	alla
laissant	leaving
gloussait	gloussait
main	hand
"vous	"you
savez	know
l'estime	the estimated
dit-il	he said
continuaient	continued
vers	to
hall	hall
sais	know
est	is
folle	crazy
bien…"	well..."
s'arrêta	stopped
soudain	suddenly
parler	talk
lavande	lavender
brown	brown
tenait	held
au	the
pied	foot
l'escalier	the stairs
marbre	marble
semblant	pretend
étourdie	dizzy
"salut	"hi
lança	launched
nerveusement	nervously
"viens"	"come on,"
murmura	whispered
filèrent	spinning
avant	before
d'entendre	to hear
m'as-tu	hast thou
sortais	out
aujourd'hui	today
était-elle	was it
toi	you
maussade	gloomy
gêné	embarrassed
apparut	appeared
demi-heure	a half-hour
tard	later
malgré	despite
assis	sitting
près	near
vit	lives
échanger	exchange
mot	word
toute	any
l'heure	the time
passèrent	passed
ensemble	all
agissait	was
fait	fact
inconsciente	unconscious
passer	pass
ou	or
deux	two
inexplicable	inexplicable
sourire	smile
sur	on
visage	face
journée	day
particulièrement	particularly
bonne	good
humeur	mood
salle	room
commune	common
consentit	consented
même	even
lire	read
devoir	duty
d'herbologie	of herbal medicine
(en	(in
termes	terms
finir	finish
d'écrire)	to write)
quelque	some
chose	thing
résolument	resolutely
refusé	refused
faire	do
jusqu'à	up to
jour	day
parce	because
savait	knew
laissait	left
ensuite	then
copier	copy
"merci	"thank you
beaucoup	a lot
tape	tape
brève	brief
car	because
vérifiant	checking
montre	watch
presque	almost
huit	eight
heures	hours
"Écoutez	"Listen
dépêche	hurry
serai	am
retard	delay
répondit	replied
biffa	biffa
simplement	simply
quelques	a few
unes	each
ses	its
mauvaises	bad
phrases	phrases
d'un	a
air	air
las	las
grimaçant	grimacing
précipita	rushed
par	by
trou	hole
portrait	portrait
s'éloigna	walked away
bureau	office
directeur	director
gargouille	gargoyle
s'écarta	departed
mentionna	mentioned
éclairs	lightning
caramel	caramel
prit	took
spirale	spiral
montant	amount
marches	steps
porte	door
exactement	exactly
l'horloge	the clock
sonnait	sounded
"entre"	"between"
l'invita	the invited
tendait	tended
pousser	push
celle	the
ouverte	open
violemment	violently
l'intérieur	inside
professeur	professor
trelawney	trelawney
"aha	"aha
gémit-elle	she moaned
pointant	pointing
dramatiquement	dramatically
doigt	finger
clignant	blinking
par-dessus	above
lunettes	glasses
grossissantes	magnifying
"ainsi	"as well
cela	this
vois	see
rejetée	rejected
sans	without
cérémonie	ceremony
votre	your
"ma	"my
chère	dear
sybille	sybille
répliqua	replied
d'exaspération	of exasperation
"il	"it
n'est	there is
aucunement	no
question	question
rejeter	reject
quiconque	anyone
n'importe	any
où	where
rendez-vous	appointment
pense	think
y	there
ait	has
dire…"	say..."
fit	fit
d'une	a
profondément	deeply
blessée	injured
"si	"if
vous	you
renvoyez	return
cet	this
usurpateur	usurper
cheval	horse
afin	in order
peut-être	maybe
trouverai-je	will I find
école	school
mes	my
talents	talent
seront	will be
mieux	better
appréciés	appreciated
poussa	pushed
disparut	disappeared
l'entendirent	heard it
trébucher	tripping
mi-chemin	mid-way
devina	devina
pris	taken
longs	long
châles	shawls
remorquait	towing
"s'il	"if it
plaît	please
fermer	close
assieds-toi	sit down
fatigué	tired
obéit	obeys
notant	noting
prenant	taking
place	place
habituelle	usual
devant	before
pensine	pensine
déjà	already
prête	ready
ainsi	as well
bouteilles	bottles
minuscules	tiny
cristal	crystal
pleines	full
souvenirs	memories
tourbillonnants	whirling
"le	"
heureuse	happy
firenze	firenze
enseignant	teacher
ici	here
hein	eh
divination	divination
s'avère	turns out
matière	material
d'ennuyeuse	of boring
l'avais	had
prévu	expected
l'ayant	having
jamais	never
étudiée	studied
moi-même	myself
demander	ask
retourner	return
forêt	forest
d'où	where
banni	banned
partir	from
entre	between
nous	we
n'a	did
aucune	no
idée	idea
danger	danger
courrait	would
dehors	outside
château	castle
sait	knows
serait	would be
imprudent	reckless
l'éclairer	the light
prophétie	prophecy
profond	deep
soupir	sigh
on	it
là	there
s'occuper	care
problèmes	problems
d'effectif	membership
avons	have
sujets	topics
importants	important
étudier	study
t'es-tu	did you
premièrement	first
acquitté	paid
tâche	task
t'ai	you've
confiée	entrusted
fin	end
notre	our
précédente	previous
"ah	"ah
leçons	lessons
transplanage	transplanage
crâna	crâna
fendu	split
détermination	determination
découvrir	discover
préparait	preparing
draco	draco
malefoy	malfoy
oublié	forgot
demandé	asked
d'obtenir	to obtain
slughorn	slughorn
"et	"and
interrogé	interviewed
cours	during
potions	potions
heu	uh
voulu	wanted
eut	had
court	short
silence	silence
constata	found
dévisageant	staring at him
demi-lune	half-moon
sensation	sensation
l'on	we
doit	must
avoir	have
passé	past
rayons	ray
x	x
estimes	reckon
fais	do
tes	your
efforts	efforts
but	purpose
as	as
exercé	exercised
ta	your
inventivité	inventiveness
n'as	did
laissé	left
recherche	search
possible	possible
inexplorée	unexplored
rechercher	search
mémoire	memory
commença	started
après	after
moment	time
chercher	search
allait	would
dire	say
unique	single
tentative	attempt
mettre	put
sembla	seemed
ridiculement	ridiculously
faible	low
"bon…	"good...
ingurgité	chugged
élixir	elixir
d'amour	love
l'ai	I
conduit	led
pensais	thought
peut-	can-
rendais	went
suffisamment	enough
humeur…"	mood..."
effectué	made
travail	work
"en	"
vérité	truth
non	not
empoisonné…	poisoned...
"…	"...
naturellement	naturally
incité	prompted
oublier	forget
concernait	concerned
serais	would be
attendu	expected
rien	nothing
d'autre	on the other
ton	your
meilleur	best
ami	friend
clair	clear
mr	mr
weasley	weasley
parfaitement	perfectly
rétablir	restore
j'aurais	I would have
espéré	hoped
revenu	income
t'avais	you had
t'avoir	you have
expliqué	explained
quelle	what
importance	importance
pourtant	yet
t'indiquer	tell you
crucial	crucial
perdions	lose
temps	time
sentiment	feeling
lourd	heavy
épineux	spiny
honte	shame
traversa	crossed
corps	body
pieds	feet
n'avait	had
élevé	high
semblé	seemed
fâché	angry
préféré	favorite
hurle	screams
cette	this
froide	cold
déception	disappointment
pire	worst
quoi	what
"professeur	"professor
désespéra-t-il	despaired-t-he
pensé	thought
juste	just
eu	had
d'autres…	other...
autres	other
choses…	things...
"d'autres	"other
soucis	worries
finit	ends
tomba	fell
inconfortable	uncomfortable
éprouvé	proven
s'installer	install
indéfiniment	indefinitely
ponctué	punctuated
ronflements	snoring
grognements	grunts
d'armando	to armando
dippet	dippet
au-dessus	above
sentit	felt
étrangement	strangely
diminué	decreased
s'il	if it
rétréci	narrowed
depuis	since
entré	entered
put	put
tenir	take
désolé	sorry
j'aurai	I will have
plus…	more...
réalisé	made
m'auriez	I would
important	important
reconnaître	recognize
calmement	calmly
puis-je	can I
espérer	hope
désormais	now
accorderas	accorderas
quête	quest
priorité	priority
élevée	high
dorénavant	now
aura	will
moins	less
récupérer	recover
ferai	will
l'obtiendrai	the get
promit-il	promise
"alors	"then
n'en	do
dirons	tell
l'instant	the moment
conclut	concludes
bonté	goodness
"continuons	"continue
histoire	history
l'avions	the aircraft
laissée	left
rappelles	remember
tué	killed
père	father
grands-parents	grandparents
croire	believe
l'œuvre	the work
oncle	uncle
morfin	morfin
retourné	returned
poudlard	hogwarts
demandé…	asked...
horcruxes	horcruxes
marmonna	muttered
penaud	sheepishly
j'espère	I hope
début	beginning
naviguerions	naviguerions
royaumes	kingdoms
idées-	ideas-
fantômes	ghosts
spéculation	speculation
“oui	“yes
”	”
"jusqu'ici	"up here
conviendras	conviendras
montré	shown
sources	sources
solides	solid
tirer	shoot
déductions	deductions
qu'avait	that was
l'âge	the age
dix-sept	seventeen
acquiesça	nodded
continua	continued
choses	things
deviennent	become
sombres	dark
étranges	strange
difficile	difficult
trouver	find
jedusor	jedusor
enfant	child
impossible	impossible
quoique	though
sujet	about
l'homme	the man
doute	doubt
âme	soul
vive	cheers
pourrait	could
plein	full
exposé	presentation
vie	life
dès	as soon
lors	when
quitta	left
cependant	however
derniers	last
voudrais	would like to
partager	share
indiqua	said
petites	small
brillant	brilliant
heureux	happy
d'avoir	to have
avis	notice
probabilité	probability
conclusions	conclusions
tirées	from
l'idée	the idea
attachait	attached
l'importance	the importance
incita	led
sentir	feel
honteux	shameful
échoué	failed
concernant	on
horcrux	horcrux
s'agita	if agita
culpabilité	guilt
siège	seat
présentait	presented
lumière	light
première	first
l'examinait	the examined
"j'espère	"I hope
n'es	no es
lassé	tired
plongée	diving
deux-là	two
curieux	curious
premier	first
vient	comes
vieille	old
elfe	elf
maison	home
appelé	called
hokey	hokey pokey
voyions	see
dont	which
témoin	witness
dois	do
rapidement	quickly
raconter	tell
comment	how
quitté	left
atteint	reached
année	year
l'instruction	the statement
aurais	would have
prévoir	provide
obtenu	obtained
meilleures	best
notes	notes
chacune	each
matières	materials
autour	around
camarades	comrades
classe	class
réfléchissaient	considering
quels	what
travaux	work
pouvaient	could
l'extérieur	outside
spectaculaires	spectacular
préfet	prefect
tom	tom
garçon	boy
talent	talent
gagnant	winner
récompense	reward
services	services
spéciaux	special
l'école	the school
plusieurs	several
professeurs	teachers
proposèrent	proposed
contacter	contact
ministère	department
magie	magic
offrant	offering
prendre	take
l'introduisant	introducing
auprès	with
contacts	contacts
utiles	useful
toutes	all
offres	offers
suivante	following
apprit	learned
travaillait	worked
chez	in
barjow	barjow
beurk	yuck
"chez	"in
and	and
répéta	repeated
assommé	knocked out
verras	see
attraction	attraction
l'endroit	the place
exerçait	exercised
aurons	will
parcouru	traveled
choix	choice
su	su
j'étais	I was
l'un	one
ceux	those
auxquels	which
confié	entrusted
d'abord	first
contacté	contacted
rester	stay
voulait	wanted
stupéfié	amazed
crois	believe
différentes	different
raisons	reasons
n'ait	did
d'elles	they
probablement	probably
manière	way
primordiale	paramount
attaché	attached
l'avait	had
aucun	no
lieu	place
personne	person
seul	only
endroit	place
considérer	consider
légèrement	slightly
troublé	troubled
mots	words
ressentait	felt
"deuxièmement	"second
forteresse	fortress
antique	antique
assurément	certainly
pénétré	penetrated
secrets	secrets
plupart	most
étudiants	students
passent	pass
estimer	estimate
mystères	mysteries
restant	remaining
éclaircir	clarify
tonnes	tons
taà	taà
troisièmement	third
tant	as
grandes	large
pouvoirs	powers
influencer	influence
jeunes	young
sorcières	witches
sorciers	wizards
avait-il	had he
lequel	which
meilleurs	best
quel	what
rôle	role
influent	influential
jouer	play
n'imagine	imagine
instant	now
envisagé	considered
reste	rest
l'a	the
vu	seen
recrutement	recruitment
povrait	povrait
commencer	start
construire	build
armée	army
trop	too
jeune	young
invité	guest
revenir	return
bout	end
souhaitait	wanted
enseigner	teach
"qu'en	"what
avez-vous	have you
hésita	hesitated
"j'étais	"I was
incommodé	bothered
j'avais	I had
conseillé	recommended
armando	armando
accepter	accept
donné	given
invoquées	invoked
fanatique	fanatic
convaincu	convinced
honnêteté	honesty
souhaitais	wanted
retour	return
position	position
puissance	power
"quel	"what
poste	post
demandait-il	he asked
voulait-il	he wanted to
façon	how
connaissait	knew
réponse	response
donne	gives
"défense	"defense
contre	against
forces	forces
mal	evil
devait	should
vieux	old
nom	name
galatea	galatea
merrythought	merrythought
enseignait	taught
cinquante	fifty
"du	"
admiré	admired
dirent	said
gâchi	gâchi
magicien	magician
travailler	work
magasin	store
employé	employee
poli	polished
beau	beautiful
intelligent	smart
s'est	is
bientôt	soon
particuliers	individuals
spécialisé	specialized
objets	objects
propriétés	properties
communes	common
puissantes	powerful
délégué	delegate
persuader	persuade
personnes	people
vendre	sell
leurs	their
trésors	treasures
associés	associated
évidence	obviously
exceptionnellement	exceptionally
doués	gifted
parierai	'll bet
acquiessa	nodded
incapable	unable
contenir	contain
l'elfe	the elf
sorcière	witch
riche	rich
hepzibah	hepzibah
smith	smith
tapa	tapa
bouteille	bottle
bouchon	cap
s'envola	flew
versa	versa
tourbillonnante	whirlpool
disant	saying
"après	"after
pencha	bent
liquide	liquid
argenté	silver
contenu	content
bassin	basin
touche	key
l'obscure	the dark
néant	nil
débarqua	landed
salon	living room
dame	lady
énorme	huge
portant	bearing
perruque	wig
raffinée	refined
gingembre	ginger
robe	dress
longue	long
rose	pink
brillante	brilliant
s'étalant	spreading
l'air	the air
gâteau	cake
regardait	watched
miroir	mirror
orné	adorned
pierreries	jeweled
tamponnait	dabbed
joues	cheeks
écarlates	scarlet
ave	ave
far	far
nuage	cloud
poudre	powder
minuscule	tiny
laçait	laçait
charnus	fleshy
chaussons	slippers
satin	satin
hâte-toi	haste thee
commanda	commanded
venait	came
quatre	four
minutes	minutes
referma	closed
étui	case
relevait	was
haut	top
atteignait	was
peine	penalty
l'assise	the seat
chaise	chair
peau	skin
papyrus	papyrus
pendait	hung
os	os
toile	canvas
croquante	crisp
drapé	draped
toge	toge
"comment	"how
tournant	turning
admirer	admire
divers	various
angles	angles
"belle	"beautiful
madame	mrs.
grinça	shrieked
supposer	assume
petits	small
caractère	character
contrat	contract
loin	far
d'être	to be
belle	beautiful
sonnette	bell
retentit	sounds
maîtresse	mistress
sursautèrent	sursautèrent
"vite	"soon
vite	fast
pleurnicha	sobbed
hors	out
pièce	room
d'objets	objects
d'imaginer	imagine
déplacer	move
cogner	banging
douzaine	dozen
d'entre	of
meubles	furniture
couverts	covered
boîtes	boxes
laquées	lacquered
caisses	crates
livres	books
dorés	golden
reliefs	reliefs
étagères	shelves
remplies	true
formes	forms
rondes	round
globes	globes
célestes	celestial
plantes	plants
s'épanouissant	blossoming
récipients	containers
croisement	crossing
d'antiquités	antique
magiques	magic
musée	museum
revint	returned
cinq	five
suivie	followed
homme	man
n'eut	had
difficulté	difficulty
identifier	identify
habillé	dressed
costume	costume
noir	black
cheveux	hair
étaient	were
avaient	had
s'étaient	had
creusées	carved
fraya	fraya
chemin	path
travers	through
indiquait	indicated
visité	visited
nombreuses	many
auparavavant	auparavavant
grasse	fat
l'effleurant	brushing
lèvres	lips
apporté	brought
fleurs	flowers
tranquillement	quietly
produisant	producing
bouquet	bouquet
roses	roses
êtes	are
vilain	naughty
devriez	should
couina	couina
remarqué	noticed
vase	vase
prêt	loan
table	table
proche	close
fatiguez	tire
asseyez-vous	sit
ah	ah
plateau	tea
gâteaux	cakes
plaça	plaça
portée	scope
"servez-vous	"now you can use
vous-même	you
aimez	love
allez-vous	are you going to
semblez	seem to
pâle	pale
exploitent	exploit
cent	cent
fois…	time...
mécaniquement	mechanically
minauda	minauda
"bon	"good
rendre	make
visite	visit
fois-ci	time
damanda-t-elle	damanda-t-it
secouant	shaking
"mr	"mr
burke	burke
voudrait	would like to
meilleure	best
proposition	proposal
l'armure	the armor
gobelins	goblins
cents	cents
gallions	galleons
semble	seems
suffisant…"	enough..."
"attends	"wait
attends	wait
penserai	will be thinking of
es	es
bibelots	trinkets
bouda	bouda
envoyé	sent
cause	cause
d'eux	of them
qu'un	a
pauvre	poor
aide	using
qu'on	we
souhaité	desired
vienne	vienna
m'enquérir…"	I inquire..."
charlatan	charlatan
coupat	coupat
ondulant	undulating
montrer	show
n'ai	haven
pouvez-vous	can you
secret	secret
promettez-moi	promise me
parlerez	speak
laisserai	let
tranquille	quiet
vends	sell
l'apprécierez	enjoy
nombre	number
peut	can
obtenir	get
voir	see
mlle	miss
veut	wants to
bébête	corny
"j'ai	"I
sortir	out
est-tu	are you
trésor	treasure
…	...
apporte	brings
es…	es...
cuir	leather
l'une	one
l'autre	the other
déplaçant	moving
elles	they
faisiaent	faisiaent
leur	their
propre	own
volonté	will
sut	sut
slalomait	slalomait
tables	tables
pouffes	pouffes
tabourets	stools
"maintenant	"now
réjouit	looking forward
posant	posing
genoux	knees
préparant	preparing
ouvrir	open
dessus	top
aimeras	love
ma	my
famille	family
peuvent	can
attendre	wait
poser	ask
ceci	this
souleva	raised
couvercle	cover
s'avança	advanced
tasse	cup
or	gold
poignées	handles
finement	finely
travaillées	worked
demande	request
allez	go
prenez-le	take the
bon	good
chuchota	whispered
tendit	handed
doigts	fingers
effilés	tapered
poignée	handle
écrin	setting
douillé	douillé
soie	silk
crut	believed
lueur	glow
rouge	red
yeux	eyes
foncés	dark
expression	expression
avide	greedy
curieusement	curiously
reflétée	reflected
sauf	except
fixés	set
beaux	beautiful
traits	features
emblème	emblem
examinant	examining
gravure	engraving
helga	helga
poufsouffle	hufflepuff
jeune-homme	young-man
penchant	leaning
fort	fort
grincement	grinding
so	so
corset	corset
creusant	digging
momentanément	momentarily
joue	plays
t'ai-je	I
lointaine	distant
descendante	top-down
transmis	transmitted
générations	generations
sortes	kinds
puissances	powers
censé	supposed to
posséder	have
testées	tested
concerve	concerve
coffre-fort	safe
ici…"	here..."
dégagea	freed
long	long
index	index
replaça	replaced
doucement	gently
boîte	box
faisant	making
top	top
attention	attention
replacer	replace
soigneusement	carefully
noter	note
l'ombre	the shadow
s'accroissait	increased
emballait	wrap
joyeusement	happily
"où	"where
oh	oh
oui	yes
là…	there...
éloigne	away
enfermée	locked
obéissance	obedience
tourna	turned
plate	flat
posée	asked
aimerez	love
chuchota-telle	whispered-such
"penchez-vous	"bend over you
pourrez	can
celà	this
acheté	bought
subodore	guess
aimerait	would like to
serai…	'll be...
glissa	slipped
fermoir	clasp
sculpté	carved
ouvrit	opened
velours	velvet
lisse	smooth
trouvait	was
médaillon	medallion
approcha	approached
présenta	presented
regardant	looking at
fixement	staring
"la	"
marque	brand
serpentard	slytherin
jouait	played
s	s
fleuri	flower
serpent	snake
exact	exact
ravi	ravi
apparemment	apparently
pétrifié	petrified
dû	due
payer	pay
bras	arm
jambe	leg
l'obtenir	get
pouvais	could
laisser	let
vrai	true
devais	had to
l'avoir	have
collection	collection
femme	woman
loques	rags
volé	stolen
vraie	true
valeur…"	value..."
tromper	fool
devinrent	became
articulations	joints
blanchir	whiten
chaîne	string
"…j'ose	"...I dare
payé	paid
broutille	mere trifle
avez…	have...
assez	enough
attribu	the procurement
contente	happy
chaud	hot
sûreté…	safety...
chercha	sought
reprendre	resume
pensa	thought
n'allait	did
lâcher	letting go
glisser	drag
coussin	cushion
“allons	“let's go
revenez	return
clairement	clearly
plu	plu
dévisagea	looked at his face
idiot	idiot
hésiter	hesitation
"allez-vous	"are you going to
cher	dear
vais	'll
“j'ai	“I
cru…	raw...
illusion	illusion
d'optique	optical
suppose…"	suppose..."
remarqua	noticed
nerveuse	nerve
aussi	also
prends	take
enferme	encloses
clé	key
sortilèges	spells
habituels…"	the usual..."
d'y	there
annonça	announced
s'éloignait	depart
sautillant	hopping
saisit	captures
coude	elbow
s'envolèrent	flew
l'oublie	forget
"hepzibah	"hepzibah
morte	dead
jours	days
scène	scene
précisa	said
retrouvant	finding
indiquant	indicating
autant	as much
"hokey	"hokey pokey
accusée	accused
empoisonné	poisoned
accidentellement	accidentally
cacao	cocoa
"quelle	"what
fâcha	angry
sommes	are
compris	including
"certainement	"certainly
puis	then
similitudes	similarities
mort	death
cas	case
accusé	accused
quelqu'un	someone
pensait	thought
causé	caused
mort…"	death..."
reconnu	recognized
faits	facts
"elle	"it
rappelé	recalled
avéré	proven
sucre	sugar
poison	poison
mortel	mortal
connu	known
conclu	concluded
volontairement	voluntarily
sénile…"	senile..."
"voldemort	"voldemort
modifié	modified
également	also
conclusion	conclusion
prédisposé	predisposed
suspecter	suspect
senti	felt
sympathie	sympathy
société	company
d'hermione	of hermione
p	p
e	e
w	w
"précisement	"precisely
admis	admitted
trifouiller	tamper
boisson	drink
s'enquérir	inquire
l'aie	the iea
retrouvé	found
sois	am
parvenue	received
extraire	extract
finie	finished
prouve	proves
l'existence	the existence
condamnée	sentenced
rendue	made
compte	account
grands	great
disparus	missing
sûr	course
utilisé	used
cachettes	hiding places
ayant	having
protégé	protected
soin	care
jaloux	jealous
aient	have
sûrs	safe
ttous	rights of
volés	stolen
l'aide	using
travaillé	worked
rendu	rendering
souvent	often
charmée	charmed
démissionné	resigned
disparu	gone
patrons	bosses
étonnés	surprised
disparition	disappearance
entendu	heard
longtemps	for a long time
dumbledore"	dumbledore"
gêne	discomfort
pause	break
attirer	attract
certains	some
points	points
commis	committed
meurtre	murder
l'as	the ace
venger	revenge
cupidité	greed
trophées	trophies
fabuleux	fabulous
abrutie	stupid
montrés	shown
enfants	children
orphelinat	orphanage
l'anneau	the ring
continué	continued
fronçant	frowned
sourcils	eyebrows
"ça	"it
fou	crazy
risquer	risk
gâcher	spoil
comprendras	understand
opportun	timely
qu'ont	that have
signifié	served
admettre	admit
considérait	considered
légitime	legitimate
propriétaire	owner
accorda	granted
appartenu	belonged
fondateurs	founders
grande	great
attirance	attraction
résister	resist
objet	object
l'histoire	the story
pense…	think...
pouvoir	power
démontrer	demonstrate
voici	here
parviennes	parviennes
retrouver	find
dix	ten
ans	years
durant	during
lesquels	which
pouvons	can
deviner	guess
faisait	was
vidait	emptied
"cela	"this
"de	"
moi"	me"
plongea	dove
suite	suite
débarquant	landing
gauche	left
fumsek	fumsek
endormi	asleep
heureusement	fortunately
perchoir	perch
semblable	similar
normales	normal
ridé	corrugated
différences	differences
actuel	current
celui-ci	it
neigeait	was snowing
taches	spots
bleuâtres	bluish
dérivaient	a drift of
fenêtre	window
l'obscurité	the dark
s'accumulaient	accumulated
rebord	rim
extérieur	outside
justement	precisely
arrivée	arrival
coups	shots
frappés	hit
"entrez	"enter
échappé	escaped
suffoqué	muffled
allure	look
émerger	emerge
chaudron	cauldron
pierre	stone
n'étaient	there were
écarlate	scarlet
masque	mask
brûlé	burned
déformé	distorted
cireux	waxy
tordu	twisted
blanc	white
sang	blood
pupilles	pupils
fentes	slots
connues	known
qu'elles	they
deviendraient	would
manteau	coat
neige	snow
scintillante	shimmering
épaules	shoulders
manifesta	manifesta
signe	sign
surprise	surprise
Évidemment	Of course
"bonsoir	"good evening
facilement	easily
"ne	"do
veux-tu	do you want to
t'asseoir	sit
quitter	leave
présent	this
"entendu	"heard
étiez	were
devenu	now
reprit-il	"he said
haute	high
"un	"a
digne	worthy
l'approuves"	the approved"
souriant	smiling
"puis-je	"and then I
t'offrir	offer you
boire	drink
bienvenu	welcome
coffret	box
gardait	kept
tendu	tense
coupe	cup
vin	wine
versé	paid
tom…	tom...
dois-je	do I have to
plaisir	fun
savoura	savoura
faut	must
m'appeler	call me
'tom'	'tom'
…"	..."
sous	under
l'arrêta	stopped
agréablement	pleasantly
peur	fear
seras	will be
irritantes	irritating
oublient	forget
habitudes	habits
jeunesse	youth
verre	glass
toast	toast
celui	the
resté	stayed
néanmoins	nevertheless
l'atmosphère	the atmosphere
changer	change
subtilement	subtly
refus	refusal
d'utiliser	use
choisi	chosen
signaler	report
entendait	heard
fixer	fix
limites	limits
réunion	meeting
étonné	surprised
soyez	be
longtemps"	for a long time"
courte	short
tel	such
"pour	"
n'être	not to be
transmettre	pass
l'ancien	the former
aidant	helping
esprits	spirits
développer	develop
rappelle	remember
ressenti	felt
l'attrait	the appeal
l'enseignement	education
auquel	which
tellement	so
conseil	council
offert	offered
ministre…"	minister..."
"trois	"three
carrière	career
m'a	me
attiré	attracted
commun	common
gorgée	sip
troubla	confused
installé	installed
attendit	waited
l'expectative	the expectant
parla	spoke
certain	some
s'y	there
attendait	waiting
l'autorisation	the authorization
devez	must
parti	party
d'ici	here
pourrais	could
expliquer	explain
sorcier	sorcerer
regarda	looked at
départ	starting
déclara-t-il	he said
rumeurs	rumors
gestes	gestures
moitié	half
À	To
demeura	remained
impassible	impassive
grandeur	size
inspire	inspires
l'envie	the desire
engendre	generates
dépit	despite
mensonges	lies
découlent	result
appelles	call
"grandeur"	"greatness"
insinua	insinua
reprit	took
semblaient	seemed to
chauffés	heated
expériences	experiences
repoussé	pushed
n'ont	have
poussées…"	flare-ups..."
genre	kind
magie…"	magic..."
corrigea	corrected
pou	pou
restes	remains
pardonne-moi	forgive me
ignorant	ignoring
mauvaise	bad
menaçante	threatening
colère	anger
vieil	old
argument	argument
moqua-t-il	a good laugh at-t-he
soutenu	supported
vos	your
célèbres	famous
déclarations	statements
l'amour	love
puissant	powerful
genres	genres
"peut-être	"maybe
regardé	watched
suggéra	suggested
recherches	research
qu'ici	here
insista	insisted
laissez-moi	let me
connaissances	knowledge
mets	mets
disposition	available
ordres	orders
qu'adviendra-t-il	what will happen to it
commandes	commands
qu'arrivera-t-il	what will happen to it
s'appellent	call
-	-
rumeur	rumor
mangemorts	mangemorts
connaisse	know
instantanément	instantly
narines	nostrils
dilater	expand
"mes	"my
amis	friends
continua-t-il	he continued
"continueront	"will continue
d'apprendre	to learn
considères	consider
l'impression	printing
domestiques	domestic
l'erreur	the error
est-ce	is this
j'allais	I was going to
sanglier	boar
trouverais	find
groupe	group
parmi	among
nott	nott
attrayant	attractive
muldber	muldber
dolohov…	dolohov...
attendant	waiting
dévoués	dedicated
effet	effect
voyager	travel
nuit	night
neigeuse	snow
souhaiter	wish
chance	chance
tentes	tents
connaissance	knowledge
détaillée	detailed
voyageaient	travelling
accueillie	hosted
omniscient	omniscient
relation	relationship
barman	bartender
local	local
posa	posa
redressa	straightened
bouts	tips
touchant	touching
geste	gesture
caractéristique	feature
"parlons	"let's talk about
ouvertement	openly
venir	come
entouré	surrounded
partisans	supporters
savons	know
froidement	coldly
étonnant	amazing
contraire	contrary
désire	wish
énormément	a lot
davantage	more
voulais	wanted
avais	had
dix-huit	eighteen
cours-tu	are you
essayer	try
directement	directly
ricana	o
refusez	refuse
travail…"	work..."
"naturellement	"of course
refuse	refuses
coupa	cut
t'attendais	was waiting for you
venant	from
visais	was aiming for
brûlait	burned
immense	huge
fureur	fury
confirma	confirmed
tour	tour
n'avons	have
ajouta	added
tristesse	sadness
recouvrait	covered
t'effrayer	frighten you
mettent	put
feu	fire
garde-robe	wardrobe
forcer	force
rembourser	refund
crimes	crimes
seconde	second
point	point
lancer	launch
avertissement	warning
injustifié	unjustified
poche	pocket
magique	magic
passa	spent
retourna	returned
ferma	closed
refermée	closed
tenaient	held
noire	black
cherchant	seeking
est-il	is it
"j'en	"I
t'en	you
parlerai	talk about
auras	auras
"quand	"when
morceau	song
l'espère	hope
sera	will be
clair…	clear...
curiosité	curiosity
dirigé	led
maintenu	maintained
défense	defence
dit…	said...
certainement	certainly
rencontre	meeting
prouvé	proven
an	year
poteau	post
