harry	harry
potter	potter
l'École	the School
sorciers	wizards
chapitre	chapter
survivant	survivor
dursley	dursley
habitaient	lived
privet	privet
drive	drive
avaient	had
toujours	always
affirmé	said
avec	with
plus	more
grande	great
fierté	pride
qu'ils	they
étaient	were
parfaitement	perfectly
normaux	normal
merci	thank you
pour	for
jamais	never
quiconque	anyone
n'aurait	would
imaginé	imagined
puissent	can
trouver	find
impliqués	involved
dans	in
quoi	what
soit	either
d'étrange	strange
mystérieux	mysterious
n'avaient	had
temps	time
perdre	lose
sornettes	drivel
dirigeait	led
grunnings	grunnings
entreprise	company
fabriquait	manufactured
perceuses	drills
c'était	it was
homme	man
grand	great
massif	massive
n'avait	had
pratiquement	virtually
mais	but
possédait	had
revanche	contrast
moustache	mustache
belle	beautiful
taille	size
quant	as
elle	it
était	was
mince	thin
blonde	blonde
disposait	had
d'un	a
deux	two
fois	time
long	long
moyenne	average
fort	fort
utile	useful
espionner	spy
voisins	neighbors
regardant	looking at
par-dessus	above
clôtures	fences
jardins	gardens
petit	small
garçon	boy
prénommé	named
dudley	dudley
leurs	their
yeux	eyes
enfant	child
monde	world
tout	all
voulaient	wanted
seule	only
chose	thing
indésirable	junk
possédaient	had
secret	secret
dont	which
craignaient	feared
qu'on	we
découvre	discover
jour	day
venait	came
entendre	hear
parler	talk
convaincus	convinced
s'en	in
remettraient	call
sœur	sister
toutes	all
s'étaient	had
revues	reviews
depuis	since
années	years
fait	fact
faisait	was
comme	as
fille	girl
unique	single
rien	nothing
mari	husband
aussi	also
éloignés	remote
possible	possible
tremblaient	the trembling
d'épouvante	horror
pensée	thought
diraient	would say
malheur	woe
montraient	showed
leur	their
savaient	knew
l'avaient	had
existence	existence
constituait	was
raison	reason
supplémentaire	additional
tenir	take
distance	distance
n'était	there was
question	question
mette	mette
fréquenter	attend
celui-là	this one
lorsque	when
s'éveillèrent	awoke
matin	morning
mardi	Tuesday
commence	begins
cette	this
histoire	history
gris	grey
triste	sad
ciel	sky
nuageux	cloudy
laissait	left
prévoir	provide
choses	things
étranges	strange
mystérieuses	mysterious
allaient	would
bientôt	soon
produire	produce
pays	country
fredonnait	hummed
nouant	building
cravate	tie
sinistre	disaster
aller	go
travailler	work
racontait	told
badin	badin
derniers	last
potins	gossip
quartier	district
s'efforçant	striving
d'installer	install
chaise	chair
bébé	baby
jeune	young
braillait	howling
toute	any
force	force
poumons	lungs
aucun	no
d'eux	of them
remarqua	noticed
gros	wholesale
hibou	owl
plumage	plumage
mordoré	golden brown
voleta	voleta
devant	before
fenêtre	window
huit	eight
heures	hours
demie	half
prit	took
attaché-case	briefcase
déposa	filed
baiser	fuck
joue	plays
essaya	tried
d'embrasser	kissing
sans	without
succès	success
celui-ci	it
proie	prey
petite	small
crise	crisis
colère	anger
s'appliquait	applied
jeter	throw
contre	against
murs	walls
pièce	room
contenu	content
assiette	plate
céréales	cereals
sacré	sacred
bonhomme	man
gloussa	chuckled
quittant	leaving
maison	home
monta	went up
voiture	car
recula	backed
l'allée	the aisle
menait	led
coin	corner
qu'il	it
première	first
détail	detail
insolite	unusual
chat	cat
lisait	read
carte	card
routière	overland
pendant	during
instant	now
comprit	understood
très	very
bien	well
voir	see
tourna	turned
alors	then
tête	head
regarder	watch
deuxième	second
avait	had
tigré	tabby
assis	sitting
moindre	less
trace	trace
qu'est-ce	what is this
passer	pass
laisser	let
abuser	abuse
reflet	reflection
soleil	sun
trottoir	sidewalk
cligna	blink
regarda	looked at
fixement	staring
soutint	supported
regard	look
tandis	while
tournait	turned
s'engageait	committed
route	road
continua	continued
d'observer	observe
rétroviseur	rear view mirror
l'animal	the animal
train	train
lire	read
plaque	plate
indiquait	indicated
voyons	see
regardait	watched
chats	cats
sont	are
incapables	unable
cartes	cards
écriteaux	signs
ressaisit	his senses
chassa	drove
esprit	spirit
durant	during
trajet	journey
vers	to
ville	city
concentra	concentra
pensées	thoughts
grosse	big
commande	command
espérait	hoped
obtenir	get
jour-là	day
lorsqu'il	when it
parvint	managed
abords	around
quelque	some
d'autre	on the other
milieu	middle
habituels	usual
embouteillages	traffic jams
forcé	forced
remarquer	notice
présence	presence
plusieurs	several
passants	passers-by
vêtus	dressed
d'une	a
étrange	strange
façon	how
portaient	wore
capes	capes
supportait	supported
gens	people
s'habillaient	dressed
manière	way
extravagante	extravagant
jeunes	young
parfois	sometimes
accoutrements	accoutrements
pensa	thought
s'agissait	was
nouvelle	new
mode	mode
particulièrement	particularly
stupide	stupid
pianota	pianota
volant	steering wheel
rencontra	met
groupe	group
olibrius	olibrius
chuchotaient	chuchotaient
l'oreille	the ear
surexcité	excited
s'irrita	became irritated
voyant	light
d'entre	of
n'étaient	there were
là-bas	there
sûrement	surely
l'empêchait	the prevented
porter	wear
cape	cape
vert	green
émeraude	emerald
quelle	what
impudence	impudence
devait	should
avoir	have
animation	animation
probablement	probably
collecter	collect
l'argent	the money
profit	profit
œuvre	work
quelconque	any
pouvait	could
être	be
file	file
voitures	cars
remit	gave
mouvement	movement
quelques	a few
minutes	minutes
tard	later
rangea	sided
parking	parking
repris	taken
place	place
bureau	office
huitième	eighth
étage	floor
s'asseyait	sat
s'il	if it
autrement	otherwise
aurait	would
doute	doubt
d'habitude	usually
concentrer	focus
matin-là	morning
hiboux	owls
volaient	flew
tire-d'aile	tire-wing
plein	full
voyaient	saw
bouche	mouth
pointaient	pointed
doigt	finger
rapaces	raptors
filaient	spun
au-dessus	above
plupart	most
même	even
nuit	night
cependant	however
d'anormal	abnormal
vint	came
troubler	disturb
matinée	morning
réprimanda	rebuked
vertement	sharply
demi-	half
douzaine	dozen
employés	employees
passa	spent
coups	shots
importants	important
poussa	pushed
hurlements	howling
supplémentaires	additional
sentit	felt
d'excellente	excellent
humeur	mood
jusqu'à	up to
l'heure	the time
déjeuner	breakfast
songea	songea
serait	would be
dégourdir	stretch
jambes	legs
traversa	crossed
s'acheter	buy
manger	eat
chez	in
boulanger	baker
d'en	to
face	in the face of
complètement	completely
sortis	out
nouveau	new
quelques-uns	a few
proximité	close
boulangerie	bakery
lançant	launching
courroucé	angry
ignorait	ignored
pourquoi	why
mettaient	put
l'aise	comfortable
ceux-là	those
boîte	box
destinée	for
récolter	harvest
quand	when
sortit	went out
boutique	shop
beignet	donut
enveloppé	wrapped
entendit	heard
mots	words
conversation	conversation
c'est	it is
j'ai	I
entendu	heard
dire	say
fils	son
s'immobilisa	froze
envahi	invaded
peur	fear
soudaine	sudden
s'apprêtait	was about
ravisa	thought better of it
hâte	looking forward
dépêcha	dispatched
remonter	back
ordonna	ordered
secrétaire	secretary
déranger	disturb
saisit	captures
téléphone	phone
presque	almost
fini	finished
composer	call
numéro	number
changea	changed
d'avis	notice
reposa	rested
combiné	combined
caressa	stroked
réfléchissait	thinking
décidément	decidedly
idiot	idiot
rare	rare
qu'un	a
nombre	number
repensait	repensait
certain	some
neveu	nephew
prénomme	her name is
véritablement	truly
après	after
s'appelait	called
peut-être	maybe
harvey	harvey
harold	harold
inutile	useless
d'inquiéter	worry
allusion	hint
mettait	put
état	state
vouloir	want to
lui-même	himself
celle-là	this one
enfin	finally
tous	all
après-midi	afternoon
beaucoup	a lot
difficile	difficult
quitta	left
bureaux	offices
cinq	five
encore	yet
préoccupé	concerned
heurta	hit
quelqu'un	someone
porte	door
navré	sorry
grommela-t-il	he growled
vieil	old
minuscule	tiny
manqué	missed
faire	do
tomber	fall
secondes	seconds
avant	before
rende	make
compte	account
l'homme	the man
portait	wore
violette	violet
d'avoir	to have
ainsi	as well
bousculé	rushed
semblait	seemed
affecté	affected
contraire	contrary
visage	face
fendit	split
large	wide
sourire	smile
répondait	met
voix	voice
perçante	piercing
attira	drew
soyez	be
cher	dear
monsieur	mr.
aujourd'hui	today
saurait	not
mettre	put
réjouissez-vous	rejoice
puisque	since
vous-savez-qui	you-know-who
disparu	gone
moldus	muggle
vous	you
devraient	should
fêter	celebrate
heureux	happy
serra	serra
poursuivre	continue
chemin	path
resta	remained
cloué	nailed
prendre	take
bras	arm
l'avait	had
appelé	called
moldu	muggle
sens	meaning
retourné	returned
espérant	hoping
victime	victim
imagination	imagination
pareille	such
détestait	hated
trait	related
l'imagination	the imagination
s'engagea	joined
n'améliora	not improved
déjà	already
remarqué	noticed
présent	this
jardin	garden
reconnaissait	recognized
dessins	drawings
pelage	coat
autour	around
allez	go
ouste	ouste
s'exclama	exclaimed
bougea	moved
contenta	contenta
sévère	severe
demanda	asked
comportement	behavior
normal	normal
essayant	trying
reprendre	resume
contenance	capacity
entra	entered
décidé	decided
révéler	reveal
femme	woman
passé	past
journée	day
agréable	nice
normale	normal
cours	during
dîner	dinner
raconta	told
problèmes	problems
voisine	nearby
côté	side
signala	reported
également	also
appris	learned
veux	want to
s'efforça	tried
conduire	lead
normalement	normally
s'installa	settled
salon	living room
journal	journal
télévisé	tv
d'après	after
témoignages	testimonials
venus	come
diverses	various
régions	regions
semblerait	seems
soient	are
comportés	behaved
présentateur	presenter
nocturnes	night
attendent	expect
chasser	hunt
proies	prey
centaines	hundreds
témoins	witnesses
oiseaux	birds
voler	fly
partout	everywhere
lever	sunrise
experts	experts
interrogés	interviewed
d'expliquer	to explain
raisons	reasons
changement	change
moins	less
étonnant	amazing
voilà	this is
conclut	concludes
s'autorisant	allowing
maintenant	now
voici	here
venue	coming
météo	weather
prévisions	forecast
mcguffin	mcguffin
est-ce	is this
doit	must
s'attendre	expect
d'autres	other
chutes	falls
prochaine	next
serais	would be
incapable	unable
répondit	replied
sachez	be aware
n'ont	have
seuls	only
comporter	include
téléspectateurs	viewers
habitent	live
éloignées	remote
unes	each
autres	other
kent	kent
yorkshire	yorkshire
côte	coast
l'Écosse	Scotland
m'ont	I have
téléphoné	phoned
qu'au	that
lieu	place
averses	showers
j'avais	I had
prévues	provided
véritables	true
pluies	rain
d'étoiles	star
filantes	shooting
s'agissait-il	was it
feux	lights
joie	joy
saison	season
pouvez	can
sûrs	safe
sera	will be
humide	wet
figea	froze
fauteuil	chair
volent	fly
bizarres	weird
murmures	whispers
tasses	cups
n'allait	did
fallait	had to
nerveux	nervous
s'éclaircit	clears up
gorge	throat
pétunia	petunia
chérie	sweetheart
dit-il	he said
n'as	did
nouvelles	new
récemment	recently
attendait	waiting
épouse	wife
parut	appeared
choquée	shocked
furieuse	furious
semblant	pretend
répondit-elle	she replied
sèchement	curtly
truc	trick
bizarre	weird
télé	tv
grommela	grumbled
histoires	stories
étoiles	star
drôle	funny
d'air	air
lança	launched
disais	said
bande	band
retroussait	retroussait
lèvres	lips
buvant	drinking
petites	small
gorgées	sips
allait	would
oser	dare
raconter	tell
prononcer	pronounce
préféra	preferred
abstenir	refrain
détaché	detached
près	near
j'imagine	I guess
répliqua	replied
raideur	stiffness
comment	how
s'appelle-t-il	refers to-t-he
howard	howard
ordinaire	ordinary
désagréable	unpleasant
avis	notice
sentant	feeling
cœur	heart
s'arrêter	stop
suis	am
d'accord	agreement
sujet	about
montaient	rose
l'escalier	the stairs
coucher	bedroom
salle	room
bains	bathroom
glissa	slipped
chambre	room
jeta	threw
coup	blow
d'œil	eye
imaginait-il	imagined it
cela	this
avait-il	had he
lien	link
s'avérait	was
parents	parents
pourrait	could
supporter	bear
mirent	started
s'endormit	fell asleep
vite	fast
éveillé	awake
retournant	returning
événements	events
consola	consoled
sombrer	sink
sommeil	sleep
vraiment	really
s'était	had
aucune	no
subissent	undergo
conséquences	consequences
pensaient	thought
espèce	species
voyait	saw
pourraient	could
mêlés	mixed
bâilla	yawned
retourna	returned
affecter	assign
tort	wrong
penser	think
emporter	take
agité	restless
montrait	showed
signe	sign
somnolence	drowsiness
restait	remained
immobile	still
statue	statue
fixant	fixing
grands	great
ouverts	open
n'eut	had
réaction	reaction
lorsqu'une	when a
portière	door
claqua	slammed
passèrent	passed
dessus	top
minuit	midnight
apparut	appeared
l'angle	the angle
observé	observed
soudainement	suddenly
silence	silence
jailli	sprung
queue	tail
frémit	shudders
rétrécirent	rétrécirent
ressemblât	sound like
vieux	old
juger	judge
couleur	color
argentée	silver
cheveux	hair
barbe	beard
descendaient	down
vêtu	dressed
longue	long
robe	dress
balayait	swept
chaussé	floor
bottes	boots
hauts	senior
talons	heels
munies	with
boucles	loops
bleus	blue
brillants	brilliant
étincelaient	sparkled
derrière	behind
lunettes	glasses
demi-lune	half-moon
crochu	hooked
donnait	gave
l'impression	printing
cassé	broken
albus	albus
dumbledore	dumbledore
l'air	the air
rendre	make
d'arriver	to arrive
qu'indésirable	that junk
occupé	busy
chercher	search
sembla	seemed
s'apercevoir	see
leva	rose
brusquement	suddenly
fixé	set
l'autre	the other
bout	end
l'amuser	the fun
rire	laugh
marmonna	muttered
j'aurais	I would have
m'en	me
douter	doubt
trouvé	found
cherchait	was looking for
poche	pocket
intérieure	inner
apparemment	apparently
briquet	lighter
argent	money
releva	rose
capuchon	cap
tendit	handed
l'alluma	lit
réverbère	street light
proche	close
s'éteignit	died
claquement	banging
alluma	lit
suivant	following
tour	tour
douze	twelve
actionna	pressed
l'Éteignoir	the Éteignoir
reste	rest
lumière	light
part	share
points	points
minuscules	tiny
brillaient	shone
loin	far
c'étaient	it was
fixés	set
regardé	watched
petits	small
perçants	piercing
passait	passed
Éteignoir	Éteignoir
marcha	walked
direction	management
parvenu	managed
s'assit	sat
muret	wall
accorda	granted
moment	time
parla	spoke
amusant	fun
professeur	professor
mcgonagall	mcgonagall
adresser	contact
souriait	smiling
d'allure	look
carrées	square
exactement	exactly
forme	form
motifs	reasons
tirés	from
chignon	bun
serré	tight
singulièrement	singularly
agacée	nettled
avez-vous	have you
demanda-t-elle	he asked as she
n'ai	haven
raide	stiff
seriez	would
restiez	stay
briques	bricks
auriez	would
célébrer	celebrate
l'événement	the event
venant	from
bonne	good
fêtes	holidays
banquets	banquets
renifla	sniffed
sais	know
fête	feast
dit-elle	she said
agacement	annoyance
seraient	would be
prudents	careful
parlé	spoken
montra	showed
plongé	immersed
l'obscurité	the dark
l'ai	I
moi-même	myself
signalé	reported
vols	flights
idiots	idiots
inévitable	inevitable
aperçoivent	see
parie	bet
dedalus	dedalus
diggle	diggle
jugeote	savvy
peut	can
douceur	smooth
nous	we
n'avons	have
grand-	grand-
onze	eleven
n'est	there is
imprudence	imprudence
folle	crazy
promener	walk
rues	streets
s'échanger	exchange
dernières	last
précaution	caution
s'habiller	dress
oblique	oblique
perçant	piercing
garda	garda
serions	would be
beaux	beautiful
draps	sheets
reprit-elle	she said
semble	seems
s'apercevaient	saw
notre	our
n'est-ce	is this
effet	effect
assura	assura
avons	have
féliciter	congratulate
diriez-vous	would you say
esquimau	eskimo
citron	lemon
friandise	treat
fabriquent	manufacture
dois	do
plutôt	rather
froidement	coldly
estimer	estimate
venu	come
glaces	ice
donc	so
parti	party
d'aussi	as
raisonnable	reasonable
devrait	should
hésiter	hesitation
croyez-vous	do you believe
essayé	tried
convaincre	convince
l'appeler	the call
voldemort	voldemort
grimace	grin
sorti	out
esquimaux	eskimos
continuons	continue
allons	will
finir	finish
créer	create
confusion	confusion
vois	see
n'en	do
voyez	see
moitié	half
exaspérée	exasperated
admirative	admiring
êtes	are
différent	different
sait	knows
seul	only
tenez	hold
flattez	blarney
tranquille	quiet
dispose	features
pouvoirs	powers
simplement	simply
parce	because
avez	have
trop	too
disons	let's say
noblesse	nobility
usage	use
heureusement	fortunately
autant	as much
rougi	red
madame	mrs.
pomfresh	pomfresh
qu'elle	it
trouvait	was
nouveaux	new
cache-oreilles	cache-ears
ravissants	lovely
comparé	compared
rumeurs	rumors
circulent	circulate
déclara-t-elle	she stated
savez	know
disparition	disappearance
l'arrêter	the stop
d'aborder	address
tenait	held
véritable	true
décidée	decided
attendre	wait
assise	sitting
glacial	icy
pénétrant	penetrating
celui	the
l'évidence	obviously
l'intention	the intention
croire	believe
disait	said
tant	as
confirme	confirms
vérité	truth
choisir	choose
autre	other
disent	say
poursuivit	continued
hier	yesterday
soir	evening
godric's	godric's
hollow	hollow
rumeur	rumor
lily	lily
james	james
morts	dead
inclina	bowed
respiration	breathing
n'arrive	arrives
voulais	wanted
l'admettre	admit it
main	hand
tapota	tapped
l'épaule	the shoulder
gravement	seriously
reprit	took
tremblante	trembling
tuer	kill
réussi	successful
supprimer	delete
bambin	toddler
personne	person
raconte	tells
parvenir	send
pouvoir	power
s'est	is
brisé	broken
hocha	hocha
sombre	dark
vrai	true
bredouilla	gabble
tués	killed
stupéfiant	amazing
fait-il	it
survivre	survive
suppositions	assumptions
saura	will
mouchoir	handkerchief
dentelle	lace
s'essuya	wiped his
sous	under
inspira	inspired
longuement	long
prenant	taking
montre	watch
consulta	consulta
aiguilles	needles
chiffres	figures
planètes	planets
tournaient	turned
bord	edge
cadran	dial
disant	saying
hagrid	hagrid
retard	delay
admit	admitted
suppose	guess
n'avez	do
endroit	place
précis	specific
confier	entrust
tante	aunt
oncle	uncle
famille	family
désormais	now
voulez	want to
s'écria	cried
levant	rising
bond	bond
pointé	pointed
observés	observed
imaginer	imagine
différents	different
donner	give
pied	foot
mère	mother
hurlant	screaming
réclamer	claim
bonbons	candy
venir	come
vivre	live
meilleur	best
ferme	farm
expliqueront	explain
écrit	written
lettre	letter
répéta	repeated
éteinte	off
rasseyant	rasseyant
croyez	believe
pareils	such
seront	will be
comprendre	understand
devenir	become
célèbre	famous
légende	legend
vivante	living
étonnée	surprised
date	date
d'aujourd'hui	today
devienne	become
l'avenir	the future
écrira	write
livres	books
enfants	children
connaîtront	will
sérieux	serious
tourner	turn
n'importe	any
quel	what
Être	Be
marcher	walk
capable	able
souvenir	remember
comprenez-vous	do you understand
vaut	worth
mieux	better
grandisse	grow
l'écart	the gap
prêt	loan
l'assumer	assume
ouvrit	opened
changer	change
avala	swallowed
salive	saliva
l'enfant	the child
va-t-il	will he
arriver	getting
jusqu'ici	up here
soudain	suddenly
pensait	thought
caché	hidden
dessous	below
l'amener	bring
sage	wise
tâche	task
importante	important
confierais	trust
propre	own
manque	lack
réticence	reluctance
reconnaissez	acknowledge
passablement	fairly
négligent	neglect
tendance	trend
grondement	rumble
sourd	deaf
bruit	noise
augmenta	increased
d'intensité	intensity
scrutaient	studying
côtés	sides
essayer	try
d'apercevoir	see
lueur	glow
phare	lighthouse
transforma	transformed
pétarade	popping
levèrent	rose
virent	saw
énorme	huge
moto	motorcycle
atterrir	land
chaussée	floor
tellement	so
peine	penalty
sauvage	wild
longs	long
noirs	black
broussaille	scrub
cachait	hid
entièrement	fully
mains	hands
couvercle	cover
poubelle	trash
pieds	feet
chaussés	shod
cuir	leather
bébés	babies
dauphins	dolphins
couvertures	blankets
immenses	huge
musculeux	muscular
soulagement	relief
déniché	found
empruntée	borrowed
géant	giant
descendant	descendant
sirius	sirius
black	black
prêtée	given
détruite	destroyed
débrouillé	managed
sortir	out
commencent	begin
rappliquer	reapply
endormi	asleep
survolé	over
bristol	bristol
penchèrent	immediately
l'intérieur	inside
visible	visible
dormait	slept
profondément	deeply
touffe	tuft
noir	black
jais	jet
distinguèrent	distinguished
front	front
coupure	cut
d'éclair	flash
murmura	whispered
gardera	keep
cicatrice	scar
pourriez	could
arranger	arrange
pouvais	could
ferais	would
cicatrices	scars
utiles	useful
j'en	I
genou	knee
gauche	left
représente	represents
plan	plan
exact	exact
métro	metro
londres	london
donnez-	give
le-moi	the me
faut	must
pourrais	could
revoir	review
pencha	bent
hirsute	shaggy
donna	donna
piquant	spicy
râpeux	râpeux
puis	then
laissa	let
échapper	escape
hurlement	howl
chien	dog
blessé	injured
chut	shhh
siffla	hissed
réveiller	wake up
désolé	sorry
sanglota	sanglota
sortant	outgoing
pois	peas
lequel	which
enfouit	buried
meurent	die
pauvre	poor
ressaisissez-vous	brace yourself
sinon	otherwise
repérer	identify
chuchota	whispered
tapotant	tapping
doucement	gently
enjambait	over
s'avançait	advanced
l'entrée	the entry
entre	between
revint	returned
trois	three
restèrent	stayed
immobiles	still
contempler	contemplate
épaules	shoulders
tremblèrent	cowered
battit	beat
paupières	eyelids
frénésie	frenzy
brillait	shone
habituellement	usually
s'éteindre	off
rester	stay
rejoindre	join
étouffée	choked
vais	'll
essuyant	wiping
revers	reverse
manche	sleeve
ruisselants	ruisselants
larmes	tears
enfourcha	enfourcha
moteur	engine
vrombissement	roar
s'éleva	rose
airs	air
disparut	disappeared
réponse	response
moucha	blew her nose
volte-face	volte-face
s'éloigna	walked away
s'arrêta	stopped
d'argent	money
l'actionna	the pressed
boules	balls
lumineuses	bright
regagnèrent	they returned to
aussitôt	as soon
réverbères	street lights
baigné	bathed
orangée	orange
distingua	distinguished
silhouette	silhouette
aperçut	saw
chance	chance
murmura-t-il	he murmured
bruissement	rustle
brise	breeze
agitait	agitated
haies	hedges
taillées	cut
silencieuse	silent
d'encre	ink
extraordinaires	extraordinary
dérouler	place
referma	closed
posée	asked
dormir	sleep
savoir	know
exceptionnel	exceptional
réveille	wake up
ouvrirait	open
bouteilles	bottles
lait	milk
semaines	weeks
piqué	stung
pincé	pinched
cousin	cousin
savait	knew
davantage	more
qu'en	in
rassemblés	gathered
levaient	rose
verre	glass
murmurant	muttering
santé	health
vitre	glass
disparaît	disappears
saut	jump
quasiment	almost
changé	changed
mêmes	same
proprets	neat
faisant	making
étinceler	sparkle
cuivre	copper
s'infiltra	infiltrated
living-	living-
room	room
semblable	similar
détails	details
télévision	tv
fameux	famous
mémoire	memory
seules	only
photos	photos
exhibées	exhibited
manteau	coat
cheminée	fireplace
donnaient	gave
idée	idea
écoulé	elapsed
distinguait	distinguished
nombreux	many
clichés	shots
exposés	exposed
ressemblait	looked like
ballon	ball
rose	pink
coiffé	wearing
bonnets	hats
pompons	pom-poms
différentes	different
couleurs	colors
blond	blond
premier	first
vélo	bike
manège	carousel
foraine	fair
ordinateur	computer
compagnie	company
père	father
couvrait	covered
baisers	kisses
deviner	guess
habitait	lived
pourtant	yet
longtemps	for a long time
réveillée	woke up
rompit	broke
debout	standing
immédiatement	immediately
réveilla	woke up
sursaut	startle
tambourina	tambourina
hurla-t-elle	screamed she
suraiguë	shrill
l'entendit	heard
s'éloigner	away
cuisine	kitchen
poser	ask
poêle	stove
cuisinière	stove
rappeler	remember
rêve	dream
beau	beautiful
volait	flying
l'étrange	the strange
impression	print
auparavant	previously
revenue	revenue
levé	survey
dépêche-toi	hurry
surveilles	watch
bacon	bacon
laisse	leaves
surtout	especially
brûler	burn
absolument	absolutely
parfait	perfect
l'anniversaire	the anniversary
grognement	grunt
glapit	"yelped
l'oublier	forget
lentement	slowly
hors	out
chercha	sought
chaussettes	socks
trouva	found
paire	pair
chassé	chased
l'araignée	the spider
installée	installed
l'une	one
d'elles	they
enfila	put on
habitué	used
araignées	spiders
placard	closet
couloir	hallway
alla	alla
table	table
montagne	mountain
cadeaux	gifts
nouvel	new
désirait	wanted
course	race
laquelle	which
voulait	wanted
mystérieuse	mysterious
sport	sport
sauf	except
boxer	boxer
punching-ball	a punching-ball
préféré	favorite
parvienne	to reach
l'attraper	the catch
rapide	fast
était-ce	was it
vivait	lived
maigre	lean
paraissait	seemed
d'autant	all
obligé	forced
vêtements	clothing
quatre	four
genoux	knees
noueux	knotty
brillant	brilliant
rondes	round
fallu	had to
rafistoler	patching up
papier	paper
collant	sticky
cause	cause
poing	fist
donnés	given
aimait	loved
apparence	appearance
physique	physical
fine	fine
éclair	flash
remontaient	dating
souvenirs	memories
rappelait	reminded
était-elle	was it
l'accident	the accident
avait-elle	had she
répondu	answered
pose	poses
questions	questions
règle	rule
observer	observe
l'on	we
l'oncle	uncle
vernon	vernon
retournait	returned
tranches	slices
peigner	comb
aboya	barked
guise	as
bonjour	hello
semaine	week
environ	about
levait	rose
crier	shout
haut	top
besoin	need
couper	cut
souvent	often
camarades	comrades
classe	class
réunis	together
différence	difference
continuaient	continued
pousser	push
c'est-à-dire	that is to say,
cuire	cook
œufs	eggs
plat	flat
arriva	came to pass
figure	figure
inexistant	non-existent
humides	wet
d'épais	thick
blonds	blonde
s'étalaient	lined
sommet	summit
épaisse	thick
grasse	fat
chérubin	cherub
cochon	pig
perruque	wig
disposer	have
assiettes	plates
remplies	true
d'œufs	eggs
facile	easy
comptait	had
terminé	finished
joues	cheeks
s'affaissèrent	slumped
trente-six	thirty-six
l'année	the year
dernière	last
chéri	darling
compté	counted
cadeau	gift
marge	margin
regarde	look at
paquet	package
papa	dad
maman	mom
t'ont	you have
offert	offered
trente-sept	thirty-seven
commençait	started
rouge	red
sentait	felt
grosses	large
colères	anger
s'empressa	hastened
d'engloutir	to engulf
l'idée	the idea
vienne	vienna
renverser	reverse
évidence	obviously
senti	felt
danger	danger
t'acheter	you buy
précipitamment	hurriedly
sortirons	come out
agneau	lamb
réfléchit	thinking
exercice	exercise
aurai	will
trente	thirty
trente-neuf	thirty-nine
canard	duck
adoré	loved
lourdement	heavily
attrapa	caught
veut	wants to
dit-	said
ébouriffant	ruffling
sonna	rang
répondre	reply
regardaient	watched
déballer	unpack
caméscope	camcorder
avion	aircraft
radio-	radio-
commandé	ordered
seize	sixteen
jeux	games
vidéo	video
magnétoscope	vcr
déchirer	rip
enveloppait	enveloped
furieux	furious
inquiet	worried
mauvaise	bad
figg	figg
jambe	leg
pourra	may
montrant	showing
horrifié	horrified
bondir	pounce
chaque	each
année	year
l'emmenaient	taking him
parcs	parks
d'attractions	attractions
cinéma	cinema
fast-foods	fast food
gaver	gaver
hamburgers	burgers
confiait	entrusted
vieille	old
chou	cabbage
montrer	show
malin	malin
jetant	throwing
responsable	responsible
situation	situation
éprouver	experience
compassion	compassion
s'écoulerait	would
entière	full
pompom	pompom
patounet	patounet
mistigri	mistigri
mignonnette	coarse
téléphoner	call
suggéra	suggested
bêtises	nonsense
déteste	hate
parlaient	spoke
dégoûtant	disgusting
sorte	so
limace	slug
disaient	said
amie	friend
s'appelle-t-elle	is called-does-it
yvonne	yvonne
vacances	holiday
majorque	mallorca
qu'à	as
intervint	intervened
d'espoir	hope
voudrait	would like to
l'ordinateur	the computer
d'avaler	swallow
entier	integer
grinça-t-elle	shrieked-t-it
reviendrons	return
ruine	ruin
ferai	will
sauter	jump
l'écoutaient	listened to it
pourrions	could
l'emmener	take
attendant	waiting
neuve	new
dedans	in
trancha	cut
pleurer	cry
bruyamment	loudly
pleurait	crying
versait	paid
vraies	true
tordre	twist
gémissant	moaning
prête	ready
accorder	grant
dudlynouchet	dudlynouchet
pleure	crying
gâcher	spoil
serrant	tightening
hurla	screamed
secouée	shaken
faux	false
sanglots	sobs
gâche	waste
adressa	addressed
horrible	horrible
sonnette	bell
d'entrée	input
retentit	sounds
dieu	god
piers	piers
polkiss	polkiss
efflanqué	efflanqué
tapait	typed
par-derrière	from behind
l'empêcher	prevent
défendre	defend
cessa	ceased
comédie	comedy
demi-heure	a half-hour
croyait	believed
l'arrière	the rear
visiter	visit
solution	solution
partir	from
pris	taken
préviens	warn
produit	product
sortiras	get out
noël	christmas
promis	promised
problème	problem
refusaient	refused
fatiguée	tired
coiffeur	hairdresser
allé	gone
ciseaux	scissors
coupé	cut
court	short
devenu	now
chauve	bald
laissé	left
qu'une	a
frange	fringe
cacher	hide
écroulé	collapsed
résultat	result
imaginant	imagining
lendemain	next day
l'école	the school
moquait	laughing
rafistolées	rafistolées
aperçu	overview
repousse	regrowth
tels	such
coupe	cup
puni	punished
malgré	despite
efforts	efforts
admettre	admit
comprenait	included
voulu	wanted
forcer	force
pull	pull
horreur	horror
marron	brown
orange	orange
essayait	tried
rapetissait	rapetissait
finalement	finally
réduit	reduced
gant	glove
poupée	doll
conclu	concluded
rétréci	narrowed
lavage	wash
fois-là	time
reçu	received
punition	punishment
ennuis	trouble
retrouvé	found
toit	roof
cantine	canteen
poursuivi	continued
cour	court
l'accoutumée	the usual
surprise	surprise
compris	including
directrice	director
affirmait	said
s'amusait	had fun
escalader	climb
bâtiments	buildings
expliqué	explained
travers	through
verrouillée	locked
contenté	just
poubelles	garbage
trouvaient	were
vent	wind
l'emporter	take
jusqu'au	until the
sautait	jumped
irait	would
valait	worth
l'odeur	the smell
conduisait	led
plaignait	complaining
plaindre	complain
travaillaient	worked
municipalité	municipality
banquier	banker
constituaient	were
sujets	topics
préférés	favorite
motos	motorcycles
conduisent	lead
malades	sick
voyous	rogue
dépassait	exceeded
rêvé	dreamed
souvenait	remember
faillit	almost
percuter	hit
précédait	preceded
betterave	beet
hurla-t-il	"he yelled,
ricanèrent	ricanèrent
regretta	regret
posait	was
détestaient	hated
l'entendre	hear
d'objets	objects
sortaient	out
rôle	role
habituel	usual
dessin	drawing
animé	animated
s'ils	if they
redoutaient	feared
tire	tire
idées	ideas
dangereuses	dangerous
samedi	Saturday
ensoleillé	sunny
bondé	crowded
familles	families
promenade	walk
achetèrent	bought
chocolat	chocolate
aient	have
repartir	leave
souriante	smiling
vendait	sold
demandé	asked
acheter	buy
sucette	lollipop
marché	market
d'ailleurs	moreover,
léchait	licked
cage	cage
gorille	gorilla
gratter	scratch
étrangement	strangely
prenait	took
éviter	avoid
commençaient	started
lasser	tired
animaux	animals
consacrent	spend
passe-temps	hobbies
favori	favorite
taper	type
déjeunèrent	déjeunèrent
restaurant	restaurant
glace	ice
géante	giant
assez	enough
goût	taste
commanda	commanded
autorisé	authorized
durer	last
allèrent	went
reptiles	reptiles
vivarium	vivarium
l'endroit	the place
frais	fees
cages	cages
éclairées	informed
s'alignaient	lined
vitres	windows
sortes	kinds
lézards	lizards
serpents	snakes
rampaient	crawling
ondulaient	ondulaient
morceaux	pieces
pierre	stone
bois	wood
d'énormes	huge
cobras	cobras
venin	venom
mortel	mortal
pythons	pythons
capables	capable
broyer	grind
étreinte	hug
dénicher	find
serpent	snake
s'enrouler	wrap
réduire	reduce
ferraille	scrap
l'instant	the moment
d'humeur	mood
tenter	try
genre	kind
d'exploit	exploit
collé	stuck
contemplait	contemplated
anneaux	rings
luisants	shiny
reptile	reptile
fais-le	do
bouger	move
geignarde	whiner
recommence	again
secs	dry
s'ennuie	bored
s'éloignant	away
traînant	dragging
s'approcha	approached
contempla	stared at
surpris	surprised
mort	death
d'ennui	boredom
imbéciles	fools
passaient	passed
pire	worst
visite	visit
celle	the
tambourinait	drummed
déplacer	move
niveau	level
clin	clin
s'assurer	ensure
plafond	ceiling
droit	right
arrêt	stop
agaçant	annoying
approuva	approved
hochement	nod
vigoureux	vigorous
d'où	where
viens	just
pointa	pointa
écriteau	sign
apposé	affixed
constrictor	constrictor
brésil	brazil
demanda-t-il	he asked
l'écriteau	the sign
suite	suite
ménagerie	menagerie
comprends	understand
confirmait	confirmed
assourdissant	deafening
sursauter	jump
regardez	watch
n'allez	not going to
dandinant	waddling
pousse-toi	push yourself
donnant	giving
côtes	coast
tomba	fell
ciment	cement
ensuite	then
arrivé	arrived
tenaient	held
firent	did
arrière	rear
poussant	pushing
cris	cree
d'horreur	horror
redressa	straightened
souffle	breath
retenait	held
prisonnier	prisoner
déroula	took place
rapidement	quickly
ondulant	undulating
panique	panic
visiteurs	visitors
précipitèrent	ran
sortie	output
terreur	terror
d'entendre	to hear
basse	low
sifflante	wheezing
merssssi	merssssi
amigo	amigo
gardien	guardian
choc	shock
répétait-il	repeated-it
passée	past
directeur	director
offrit	offered
tasse	cup
confondit	confounded
excuses	apologies
balbutiaient	balbutiaient
ahuri	bemused
claquer	slam
mâchoires	jaws
mollets	calves
s'amuser	have fun
failli	bankrupt
arracher	snatch
l'étouffer	the choke
s'enroulant	winding
calmé	calmed down
attendit	waited
rentré	back
fureur	fury
telle	such
seulement	only
s'effondra	collapsed
hâta	haste
d'aller	go
cognac	cognac
allongé	lying
désolait	upset
couchés	lying
dormaient	slept
risquer	risk
discrètement	discreetly
sinistres	claims
accident	accident
fouillait	searched
entières	whole
vision	vision
émergeait	there was
revoyait	review
aveuglant	blinding
verte	green
brûlure	burn
douloureuse	painful
pensait-il	he thought
n'eût	had it
l'origine	the original
photo	photo
parent	parent
lointain	distant
inconnu	unknown
l'emmène	the takes
simple	simple
espoir	hope
croisait	crossed
dehors	outside
reconnaissaient	recognized
chapeau	hat
violet	purple
incliné	inclined
courses	races
connaissait	knew
dépêchée	sent
magasin	store
acheté	bought
échevelée	dishevelled
habillée	dressed
signes	signs
pourpre	purple
reparti	left
semblaient	seemed to
disparaître	disappear
d'ami	friend
cassées	broken
envie	want
déplaire	displease
lettres	letters
nulle	void
fuite	leak
brésilien	brazilian
valut	earned
reçue	received
ressortir	out
d'été	summer
commencé	started
casser	break
d'écraser	crush
d'étrenner	of première
renversant	reversing
traversait	crossed
béquilles	crutches
content	content
n'arrivait	there was
dennis	dennis
malcolm	malcolm
gordon	gordon
stupides	stupid
bête	beast
qu'eux	that they
chef	chief
ravis	happy
pratiquer	practice
chasse	hunting
environs	surrounding area
pensant	thinking
représentait	represented
septembre	September
entrerait	would
collège	college
école	school
smelting	smelting
privé	private
études	studies
inscrit	registered
contenter	just
ravi	ravi
trou	hole
toilettes	toilet
t'entraîner	lead you
monte	monte
pauvres	poor
atroce	atrocious
rendrait	would
juillet	July
emmena	took
l'uniforme	the uniform
pénible	painful
l'ordinaire	the ordinary
trébuchant	stumbling
refroidi	cooled
passion	passion
mangeant	eating
gâteau	cake
séjourner	stay
fond	background
parada	parada
habits	clothes
flambant	brand
neufs	new
frac	frac
queue-de-pie	tail-of-pie
pantalon	pants
golf	golf
canotier	boater
élèves	students
canne	cane
servaient	served
professeurs	teachers
parait-il	it seems
forger	forge
caractère	character
contemplant	contemplating
accoutré	accoutré
déclara	said
éclata	broke out
élégant	elegant
dudlinouchet	dudlinouchet
s'être	will be
fêlé	cracked
réprimer	suppress
odeur	smell
pestilentielle	pestilentielle
dégageait	radiated
bassine	basin
l'évier	the sink
flottaient	floating
grisâtre	greyish
pinça	pinched
l'audace	the audacity
uniforme	uniform
s'étonna	was surprised
savais	knew
tremper	soak
l'eau	the water
fais	do
l'idiot	the idiot
teint	complexion
vieilles	old
affaires	business
suffira	suffice
guère	little
doutait	doubted
discuter	discuss
ressemblerait	would look like
rentrée	back to school
peau	skin
arrachés	torn
éléphant	elephant
entrèrent	went
fronçant	frowned
répandait	spread
séparait	separated
entendirent	heard
facteur	factor
glisser	drag
courrier	mail
donne-lui	give him
évita	evita
postale	postal
l'île	the island
wight	wight
enveloppe	envelope
kraft	kraft
facture	invoice
bonds	bonds
poitrine	chest
balle	ball
caoutchouc	rubber
d'amis	friends
bibliothèque	library
évitait	avoided
recevoir	receive
désagréables	unpleasant
exigeant	requiring
retour	return
empruntés	borrowed
l'adresse	the address
prêter	pay
little	little
whinging	whinging
surrey	surrey
l'enveloppe	the envelope
lourde	heavy
faite	made
parchemin	parchment
jauni	yellowed
écrite	written
l'encre	the ink
timbre	stamp
tremblantes	trembling
sceau	seal
cire	wax
frappé	hit
écusson	crest
aigle	eagle
lion	lion
blaireau	badger
entourant	surrounding
cria	cried
regardes	look at
piégée	trapped
plaisanterie	joke
éclater	burst
quitter	leave
entreprit	undertook
décacheter	to be opened
jaune	yellow
dégoûté	disgusted
ouvrant	opening
malade	sick
mangé	ate
coquillage	shell
point	point
déplier	unfold
arracha	tore
protesta	protested
t'écrirait	you would write
mépris	contempt
secoua	shook
signalisation	signaling
pâle	pale
porridge	porridge
balbutia	stammered
s'emparer	grab
portée	scope
ligne	line
intrigué	intrigued
s'évanouir	vanish
porta	porta
s'échappa	escaped
borborygme	borborygme
étouffé	choked
regardèrent	looked
oublié	forgot
l'habitude	the usual
manifeste	manifest
indifférence	indifference
forte	strong
sortez	get out
d'ici	here
grinçante	squeaky
remettant	delivering
laissez-moi	let me
exigea	demanded
rugit	roars
claquant	slamming
engagèrent	hired
combat	combat
féroce	fierce
silencieux	silent
écouterait	listen to
serrure	lock
l'emporta	took it to
bataille	battle
s'allongea	lain
ventre	belly
écouter	listen
l'interstice	the gap
ont-ils	have they
couche	layer
crois	believe
surveillent	monitor
espionnent	spy on
suivent	follow
furieusement	furiously
qu'allons-nous	what are we going to
voulons	want to
apercevait	caught sight of
chaussures	shoes
noires	black
cirées	polished
cent	cent
attention	attention
reçoivent	receive
n'allons	not going to
souviens-toi	remember
l'avons	have
sommes	are
juré	juror
refuser	refuse
idioties	baloney
dangereux	dangerous
revenant	returning
travail	work
faufilait	faufilait
adressée	addressed
erreur	error
brûlée	burned
tombèrent	fell
respira	breathed
reprises	times
força	forced
douloureux	painful
justement	precisely
réfléchi	thought
commences	start
pensé	thought
peut-	can-
préférable	best
déménages	move
prends	take
chambres	rooms
servait	served
généralement	generally
jouets	toys
n'entrait	did
voyage	travel
suffit	just
transporter	carry
objets	objects
cassés	broken
posé	asked
char	char
d'assaut	assault
pédales	pedals
écrasé	crushed
voisin	neighbor
éventrée	gutted
émission	issue
préférée	favorite
annulée	cancelled
vécu	lived
autrefois	once
perroquet	parrot
échangé	exchanged
carabine	rifle
comprimé	tablet
étagère	shelf
tordue	twisted
étagères	shelves
auxquelles	which
n'avoir	have
touché	hit
rez-de-chaussée	ground floor
s'adressait	addressed
là-dedans	there
criait-il	"he shouted
soupira	sighed
s'étendit	spread
veille	eve
donné	given
aimé	loved
d'être	to be
égosillé	égosillé
vomir	vomit
exprès	express
jeté	cast
tortue	turtle
serre	greenhouse
récupérer	recover
heure	time
regrettait	regretted
amèrement	bitterly
ouvert	open
hall	hall
échangeaient	exchanged
sombres	dark
regards	looks
efforcé	tried
aimable	kind
envoya	sent
l'entendirent	heard it
hurler	scream
étranglé	strangled
précipita	rushed
battre	beat
terre	earth
attrapé	caught
instants	moments
duquel	which
chacun	each
crispée	creased
rauque	hoarse
va-t'en	go
inlassablement	tirelessly
déménagé	moved
signifiait	meant
essaierait	try
s'arrangerait	would
réveil	alarm clock
rafistolé	patched up
arrêta	stopped
sonnerie	ringtone
s'habilla	dressed
descendit	went down
allumer	turn on
lumières	lights
arrive	happens
demander	ask
battant	flying
aaaaaarrrgh	aaaaaarrrgh
molle	soft
étalée	spread
s'allumèrent	lit up
rendit	made
réalité	reality
couchage	sleeping
empêcher	prevent
réussir	succeed
tenté	tried
l'avoir	have
traité	treaty
noms	names
préparer	prepare
découragé	discouraged
adressées	directed
commença-t-il	he began
n'alla	did not go to
cloua	nailed it
planche	board
n'arrivent	arrive
finiront	will
pleine	full
clous	nails
servira	will
grand-chose	much
gens-là	people
raisonnent	reason
répliqua-t-il	he replied
planter	plant
clou	nail
morceau	song
cake	cake
apporter	bring
vendredi	Friday
arrivèrent	arrived
boite	box
inutilisable	unusable
elles	they
glissées	slipped
introduite	introduced
vasistas	transom windows
brûlé	burned
marteau	hammer
boucha	busha
l'aide	using
planches	boards
interstices	interstices
portes	doors
entrer	enter
devint	became
incontrôlable	uncontrollable
vingt-quatre	twenty-four
destinées	for
furent	were
introduites	introduced
roulées	rolled
dissimulées	hidden
douzaines	dozens
livreur	driver
déconcerté	baffled
passées	past
poste	post
crémier	milk jug
auprès	with
protester	protest
réduisit	reduced
bouillie	boiled
mixer	mix
t'écrire	you write
abasourdi	stunned
dimanche	Sunday
fatigué	tired
fonctionne	works
joyeux	happy
étalant	spreading
consciencieusement	conscientiously
marmelade	marmalade
conduit	led
sifflement	whistle
sonore	sound
d'exploser	explode
foyer	home
projetant	projecting
quarantaine	quarantine
boulets	ball
canon	canon
baissèrent	lowered
projectiles	projectiles
attraper	catch
projeta	projected
eurent	had
protégeant	protecting
panneau	panel
entendait	heard
rebondissant	bouncing
carrelage	tile
fois-ci	time
s'efforçait	tried
calme	quiet
arrachant	snatching
touffes	tufts
poils	hair
emportez	take
discussion	discussion
menaçant	threatening
dégarnie	thinning
n'osa	durst
geste	gesture
arraché	ripped
condamnaient	condemned
montèrent	went up
fonça	rushed
l'autoroute	the highway
pleurnichait	pleurnichait
retardés	delayed
voulant	wanting to
prix	price
roulèrent	rolled
elle-même	itself
n'osait	did not dare to
emmener	take
demi-tour	half-round
repartait	went
opposée	opposite
semer	sow
marmonnait-il	muttered-it
boire	drink
tombée	fallen
faim	hunger
raté	missed
émissions	emissions
pulvériser	spray
extraterrestre	alien
hôtel	hotel
banlieue	suburban
partagèrent	shared
lits	beds
jumeaux	twins
sentaient	felt
moisi	musty
ronfler	snoring
rebord	rim
phares	headlights
servit	served
corn	corn
flakes	flakes
rassis	stale
toasts	toast
froids	cold
recouverts	covered
tomates	tomatoes
patronne	patron saint
l'hôtel	the hotel
'mande	'mande
pardon	forgiveness
parmi	among
centaine	hundred
réception	reception
adresse	address
rail	rail
carbone	carbon
miness	miness
l'en	the
empêcha	prevented
occupe	deals
l'hôtelière	the hotel
rentrions	walk
timidement	timidly
entendue	heard
conduisit	led
forêt	forest
inspecta	inspected
alentours	around
remonta	came up
repartirent	arena
recommença	again
champ	field
pont	bridge
suspendu	suspended
étages	floors
l'après-midi	in the afternoon
village	village
enferma	locked up
effaré	aghast
pluie	rain
commença	started
gouttes	drops
martelaient	martelaient
lundi	Monday
aille	go
aura	will
confiance	trust
trompait	wrong
dates	dates
programmes	programs
souvint	sarah
onzième	eleventh
anniversaire	anniversary
anniversaires	birthdays
réjouissant	pleasing
précédente	previous
cintre	hanger
appartenu	belonged
jours	days
portant	bearing
refusa	refused
lorsqu'elle	when it
idéal	ideal
venez	come
froid	cold
rocher	rock
cabane	hut
misérable	miserable
certaine	some
prévoit	provides
tempête	storm
bateau	boat
édenté	toothless
barque	boat
balançait	rocking
surface	surface
métallique	metal
provisions	provisions
embarquer	embed
polaire	polar
embruns	spray
s'insinuaient	if insinuaient
glacé	glossy
fouettait	whipped him
s'écouler	take
atteignent	reach
glissant	sliding
masure	hovel
épouvantable	terrible
régnait	reigned
terrible	terrible
d'algues	algae
sifflait	whistled
fissures	cracks
comportait	included
bûche	log
pièces	parts
maigres	lean
chips	chips
bananes	bananas
emballages	packaging
vides	empty
consumèrent	consumed
parvenant	managing
fumée	smoke
aimerait	would like to
quelques-unes	some
joyeusement	happily
convaincu	convinced
parviendrait	would
braver	brave
réjouissait	looking forward
annoncée	announced
souffler	blow
l'écume	the foam
vagues	wave
fracassaient	fracassaient
inondait	flooded
trembler	shake
fenêtres	windows
crasseuses	crasseuses
dénicha	unearthed
moisies	mouldy
canapé	sofa
rongé	corroded
mites	moths
défoncé	smashed
s'efforcer	strive
s'enroula	twined himself
couverture	coverage
déchirée	torn
devenait	became
violente	violent
mesure	measurement
avançait	advanced
couché	lying
parvenait	could
s'endormir	falling asleep
frissonnait	shuddered
tournant	turning
position	position
inconfortable	uncomfortable
vide	empty
criait	shouted
famine	famine
tonnerre	thunder
retentir	sound
étouffaient	choking
ronflements	snoring
pendait	hung
l'accoudoir	the armrest
phosphorescent	phosphorescent
poignet	wrist
gras	fat
demandant	asking
demandait	asked
l'auteur	the author
grincer	squeak
au-dehors	outside
s'effondrer	collapse
priver	deprive
arriverait	happen
etait-ce	was this
cognait	bumped
craquement	crunch
menaçait-il	threatened-it
minute	minute
vingt	twenty
neuf	nine
réveillait	woke up
l'énerver	the excited
boum	boom
frappait	hit
clés	key
frappa	hit
bêtement	stupidly
fusil	rifle
contenait	contained
cria-t-il	he shouted
armé	armed
craaaaac	craaaaac
cogna	knocked
arrachée	torn
gonds	hinges
fracas	crash
l'encadrement	coaching
crinière	mane
emmêlés	tangled
broussailleuse	scrub
distinctement	distinctly
scarabées	beetles
foisonnement	abundance
inclinant	tilting
cogner	banging
ramassa	picked up
difficulté	difficulty
vacarme	din
atténué	attenuated
aviez	had
refus	refusal
s'avança	advanced
resté	stayed
pétrifié	petrified
bouge-toi	bouge-toi
courut	ran
réfugier	refuge
terrifiée	terrified
rides	wrinkles
apparaître	appear
scarabée	beetle
t'ai	you've
n'étais	there was
ressembles	look like
j'exige	I require
sortiez	walk out the door
commis	committed
violation	violation
domicile	home
effraction	break-in
pruneau	prune
nœud	node
facilement	easily
émit	issued
souris	mouse
souhaite	wish
apporté	brought
m'asseoir	sit
tira	drew
carton	carton
légèrement	slightly
aplatie	flattened
l'ouvrit	the opened
tremblant	tremblant
découvrit	discovered
fondu	melted
glaçage	frosting
perdirent	lost
s'entendit	heard
êtes-vous	are you
présenté	presented
rubeus	redglow
lieux	places
poudlard	hogwarts
secouant	shaking
faudrait	should
frottant	rubbing
remarquez	notice
paquets	packages
calcinés	charred
l'âtre	the hearth
d'enfer	hell
ronflait	lay snoring
lueurs	light
dansantes	dancing
chaleur	heat
répandre	spread
plonger	dive
bain	bath
tiède	warm
rassit	stales
s'écrasa	crashed
poids	weight
bouilloire	kettle
saucisses	sausages
tisonnier	poker
théière	teapot
ébréchées	chipped
bouteille	bottle
liquide	liquid
ambré	amber
gorgée	sip
grillées	grilled
grésiller	sizzle
répandit	spread
s'affairait	was busy
juteuses	juicy
brûlées	burned
frétiller	wag
touche	key
donnera	give
narquois	mocking
votre	your
lard	bacon
d'engraisser	fatten up
inquiétez	worry
paru	published
délicieux	delicious
détacher	detach
explication	explanation
appelle-moi	call me
qu'est	that is
scandalisé	scandalized
tassèrent	tassèrent
eux-mêmes	themselves
pénombre	penumbra
désolés	sorry
recevais	received
j'ignorais	I didn't know
n'avais	had
t'es	you're
tonna	thundered down
attends	wait
remplir	complete
l'espace	the space
recroquevillés	curled up
exagérait	exaggerated
bonnes	good
notes	notes
certaines	some
mathématiques	mathematics
dédaigneux	dismissive
livide	livid
maisnonmaisquoimaispasdutout	maisnonmaisquoimaispasdutout
saches	to know
célèbres	famous
doigts	fingers
retrouva	found
l'usage	the use
parole	word
ordonna-t-il	he ordered
défends	defend
courageux	brave
flanché	flinch
reprit-il	"he said
détachant	stain remover
syllabe	syllable
rage	rage
laissée	left
j'étais	I was
déposer	file
interdis	wouldn't
exclamation	exclamation
transformer	transform
pâté	block
sorcier	sorcerer
s'abattit	beat down
n'entendait	did
s'appuyant	based
dossier	folder
craqua	cracked
deviendras	will become
auras	auras
d'entraînement	training
tiens	want
lises	quicksand
plancher	floor
collÈge	college
École	School
sorcellerie	witchcraft
commandeur	commander
grand-ordre	large-order
merlin	merlin
docteur	doctor
enchanteur-en-chef	enchanter-in-chief
manitou	manitou
suprême	supreme
confédération	confederation
internationale	international
mages	the magi
plaisir	fun
informer	inform
bénéficiez	get
d'ores	now
inscription	registration
trouverez	find
ci-joint	attached
liste	list
ouvrages	books
équipements	equipment
nécessaires	needed
déroulement	conduct
scolarité	tuition
étant	being
fixée	fixed
attendons	expect
veuillez	please
l'expression	the expression
sentiments	feelings
distingués	distinguished
minerva	minerva
adjointe	assistant
qu'elles	they
explosaient	exploded
d'artifice	fireworks
commencer	start
s'écoula	passed
décide	decides
bredouilla-t-il	gabble-t-he
mille	thousand
gorgones	gorgonians
j'allais	I was going to
oublier	forget
tape	tape
suffi	enough
cheval	horse
vivant	living
froissé	crumpled
plume	pen
d'oie	goose
rouleau	roll
langue	language
dents	teeth
griffonner	scribbling
l'envers	the upside
demain	tomorrow
affreux	awful
j'espère	I hope
roula	roula
billet	ticket
ouvrir	open
l'oiseau	the bird
s'asseoir	sit
ouverte	open
refermer	close
étais-je	was I
poster	post
j'aimerais	I would like to
s'avise	effectively
intéressé	interested
appelons	call
magiques	magic
grandi	grew up
incroyable	amazing
j'aie	I have
rencontrée	met
balivernes	baloney
débarrasser	rid
saviez	did
savions	knew
aurait-il	would it
qu'était	that was
maudite	cursed
celle-ci	it
partie	part
revenait	back
poches	pockets
pleines	full
têtards	tadpoles
changeait	changed
rats	rats
d'égout	sewer
monstre	monster
par-ci	here
par-là	there
fiers	proud
sorcière	witch
s'interrompit	if interrupted
respirer	breathe
tirade	tirade
attendu	expected
d'oser	dare
rencontré	met
mariés	married
anormal	abnormal
exploser	explode
hérité	inherited
retrouver	find
m'avez	I have
sursautant	jumping up
violemment	violently
retournèrent	returned
terrer	terrer
insulte	insult
scandale	scandal
connaît	knows
connaissent	know
avide	greedy
m'attendais	was expecting
inquiète	concerned
prévenu	warned
ramener	bring
doutais	suspected
courant	current
demande	request
placé	placed
fasse	do
peux	can
pourrai	can
mystères	mysteries
récit	story
l'histoire	the story
personnage	character
s'appelle	is called
n'aies	hast
n'aime	likes
l'éviter	avoid
gargouille	gargoyle
bougre	bugger
diable	devil
tourné	shot
tourne	turns
l'écrire	the write
s'écrit	written
allons-y	let's go
l'immense	the immense
corps	body
parcouru	traveled
frisson	thrill
m'oblige	makes me
répéter	repeat
vingtaine	twenty
d'années	years
adeptes	followers
certains	some
l'ont	have
suivi	follow-up
profiter	enjoy
époque	time
lier	link
d'amitié	friendship
sorcières	witches
terribles	terrible
résistaient	resisted
tuait	killed
effroyable	appalling
l'un	one
endroits	places
sécurité	security
arrivait	arrived
tu-sais-qui	you-know-who
s'attaquer	address
moment-là	time
d'excellents	excellent
premiers	first
l'époque	the time
étudiants	students
mystère	mystery
sais-qui	know-who
amener	bring
camp	camp
proches	close
ténèbres	darkness
dizaine	ten
halloween	halloween
rendu	rendering
habitiez	live
avais	had
sale	dirty
corne	horn
brume	mist
excuse-moi	excuse me
connaissais	knew
charmants	charming
puisse	can
tu-sais-	you-know-
blessure	injury
mauvais	bad
sort	fate
lancé	launched
puissant	powerful
détruit	destroyed
ceux	those
supprimé	deleted
mckinnon	mckinnon
boncs	boncs
prewett	prewett
survécu	survived
approchait	approaching
l'éclair	the flash
nettement	clearly
cruel	cruel
tristesse	sadness
confié	entrusted
mission	mission
amené	led
monceau	monceau
fariboles	fariboles
sursauta	gasped
courage	courage
poings	fists
serrés	tight
lançait	launched
écoute-moi	listen to me
lança-t-il	"he shouted,
bizarreries	quirks
suffirait	would
correction	correction
drôles	funny
zigotos	guys
cherchaient	looking
espèces	species
magiciens	magicians
finiraient	would
bondit	leaps
parapluie	umbrella
délabré	run-down
épée	sword
rugit-il	roars-it
perspective	perspective
embroché	donned
barbu	bearded
s'aplatit	flattens
j'aime	I love
respirant	breathable
foule	crowd
qu'est-il	what is it
volatilisé	volatilized
ajoute	adds
réputation	reputation
puissance	power
calembredaines	calembredaines
suffisamment	enough
humain	human
mourir	die
pensent	think
ralliés	joined
revenus	income
plongés	immersed
transe	trance
pense	think
auraient	would
s'arracher	tear
revenu	income
croient	believe
perdu	lost
faible	low
continuer	continue
nuit-là	night
phénomène	phenomenon
auquel	which
s'attendait	expected
respect	respect
sympathie	sympathy
ressentir	feel
certitude	certainty
malentendu	misunderstanding
serait-ce	would it be
brutalisé	assaulted
malmené	manhandled
changés	changed
crapauds	toads
l'enfermaient	enclosed
vaincre	defeat
faisait-il	was it
traiter	treat
football	football
rappelle-toi	remember
étais	was
rendaient	made
produites	produced
émotion	emotion
paniqué	panicked
ridicule	ridiculous
repousser	push
tignasse	mop
s'était-il	was he
vengé	avenged
lâchant	dropping
sourit	smiles
rayonnait	shone
verras	see
abandonner	abandon
n'ira	will not go
fera	will
reconnaissant	recognizing
sottises	nonsense
l'obligeait	the required
grimoires	grimoires
baguettes	chopsticks
opposer	object
grogna	" 
naissance	birth
étudier	study
meilleure	best
sept	seven
transformé	transformed
appartiennent	belong
étudiera	consider
maîtres	masters
comptés	counted
dumbled	dumbled
refuse	refuses
payer	pay
cinglÉ	crazy
apprenne	learn
tours	towers
magie	magic
empoigna	grabbed
tournoyer	twirl
insulter	insult
tonna-t-	thundered down-t-
abattit	cut down
détonation	detonation
pétard	firecracker
explose	explodes
aigu	acute
dansait	dancing
douleur	pain
plaquées	plated
volumineux	large
postérieur	post
tire-bouchon	corkscrew
poussé	pushed
rugissement	roar
entraîna	led
dernier	last
terrifié	terrified
caressant	stroking
n'aurais	would have
m'énerver	annoy me
regret	regret
ressemble	looks like
sourcils	eyebrows
broussailleux	bushy
t'en	you
censé	supposed to
l'autorisation	the authorization
servir	serve
t'apporter	bring you
confie	entrust
élève	student
renvoyé	returned
troisième	third
baguette	wand
magique	magic
permis	permit
garde-chasse	gamekeeper
t'inquiète	don't worry
remue	brainstorming
loirs	dormice
traverse	crosses
fermés	closed
demi-sommeil	a half-sleep
nommé	named
existait	was
frapper	hit
pensais	thought
marmonna-t-il	mumbled to himself he
cogne	cogne
résigné	resigned
illuminé	illuminated
cessé	stopped
patte	paw
carreau	tile
éprouvait	felt
sensation	sensation
bonheur	happiness
sentir	feel
flotter	float
posa	posa
l'attaqua	the attacked
menaça	threatened
claquements	clicks
féroces	fierce
paye-le	pays-the
paye	pay
constitué	consisting
uniquement	only
trousseaux	keychains
limaces	slugs
pelotes	balls
ficelle	string
menthe	mint
sachets	bags
finit	ends
poignée	handle
monnaie	currency
semblèrent	seemed
noises	noises
ensommeillée	ensommeillée
bronze	bronze
bourse	stock exchange
attachée	attached
s'envola	flew
ferait	would
bâillement	yawn
ressenti	felt
crever	pierce
chaussant	footwear
va-t-on	va-t-on
gardaient	kept
gringotts	gringotts
banque	bank
mange	eat
saucisse	sausage
mauvaises	bad
froides	cold
mangerais	he would eat
d'anniversaire	birthday
banques	banks
dirigée	led
gobelins	goblins
missions	missions
importantes	important
suivit	followed
clair	clear
étincelait	sparkled
louée	rented
inondée	flooded
d'eau	water
cherchant	seeking
embarcation	boat
revenir	return
s'installèrent	settled
observait	watched
ramer	rowing
m'arrange	I want to
accélérer	accelerate
parleras	talk
seras	will be
pointe	tip
fila	fila
rivage	shore
pareil	such
sorts	spells
dépliant	leaflet
dragons	dragons
gardent	keep
coffres	chests
kilomètres	kilometres
sous-sol	basement
finirait	would
gazette	gazette
contact	contact
résister	resist
ministère	department
pages	pages
nommer	name
ministre	minister
quitterait	leave
gâteux	gâteux
cornelius	cornelius
fudge	fudge
gaffeur	blunderer
envoie	sends
conseil	council
sert	serves
garder	keep
secrets	secrets
sachent	know
essaieraient	try
appel	call
résoudre	solve
préfère	prefer
laissent	leave
tranquilles	quiet
quai	dock
port	port
replia	flexed
gare	station
retournaient	return
cessait	stopped
commentaires	comments
haute	high
disait-il	he said
parcmètres	parking meters
l'esprit	the spirit
tordu	twisted
inventer	invent
trucs	tips
marchait	walked
suivre	follow
essoufflé	out of breath
méduses	jellyfish
dragon	dragon
arrivés	arrived
confia	entrusted
soin	care
d'acheter	buy
billets	tickets
passagers	passengers
ouvraient	opened
ronds	round
occupait	occupied
sièges	seats
tricotait	knitting
chapiteau	tent
cirque	circus
canari	canary
comptant	cash
mailles	mesh
fournitures	supplies
feuille	sheet
remarquée	noticed
devront	will have to
obligatoirement	mandatory
équipés	equipped
robes	dresses
modèle	model
pointu	sharp
gants	gloves
protecteurs	protectors
matière	material
d'hiver	winter
noire	black
attaches	fasteners
vêtement	garment
devra	should
étiquette	label
indiquant	indicating
l'élève	the student
manuels	manuals
procurer	buy
exemplaire	copy
suivants	the following
livre	book
enchantements	enchantments
miranda	miranda
fauconnette	fauconnette
bathilda	bathilda
tourdesac	tourdesac
théorique	theoretical
adalbert	adalbert
lasornette	lasornette
manuel	manual
métamorphose	metamorphosis
débutants	beginners
emeric	emeric
herbes	herbs
champignons	mushrooms
phyllida	phyllida
augirolle	augirolle
potions	potions
arsenius	arsenius
beaulitron	beaulitron
habitat	habitat
fantastiques	fantastic
norbert	norbert
dragonneau	dragon
forces	forces
obscures	dark
protéger	protect
quentin	quentin
jentremble	jentremble
chaudron	cauldron
standard	standard
étain	tin
fioles	vials
cristal	crystal
télescope	telescope
balance	balance
peuvent	can
crapaud	toad
rappelÉ	recalled
ÉlÈves	Students
premiÈre	first
annÉe	year
autorises	authorized
possÉder	have
balai	broom
connaître	know
transports	transport
commun	common
coincé	stuck
portillon	gate
automatique	automatic
plaignit	haste
tonitruante	thunderstrike
rames	trains
lentes	slow
font	do
escaladaient	climbed
escalier	staircase
roulant	rolling
panne	failure
animée	animated
bordée	lined
magasins	stores
trottoirs	sidewalks
dense	dense
frayer	spawn
prudemment	cautiously
sillage	wake
librairies	libraries
disques	disks
stands	stands
cinémas	cinemas
vendre	sell
marchaient	walked
entouraient	surrounded
montagnes	mountains
d'or	gold
enterrées	buried
boutiques	shops
vendaient	sold
balais	brushes
volants	flying
n'était-ce	was this
farce	stuffing
l'humour	humor
raconté	told
s'empêcher	help
baveur	leaky
miteux	shabby
librairie	library
montré	shown
l'aurait	would have
paraisse	seems
femmes	women
assises	foundation
buvaient	drank
verres	glasses
xérès	sherry
fumait	smoked
pipe	pipe
parlait	spoke
barman	bartender
noix	nuts
scintillante	shimmering
conversations	conversations
adressait	addressed
parts	units
sourires	smiles
tendant	for
rangée	row
fléchirent	fléchirent
seigneur	lord
clients	customers
dirent	said
honneur	honor
contourner	work around
comptoir	counter
serrer	tighten
bienvenu	welcome
bienvenue	welcome
tournés	shot
continuait	continued
tirer	shoot
chaises	chairs
racler	scrape
entouré	surrounded
client	client
doris	doris
crockford	crockford
extraordinaire	extraordinary
fier	proud
voire	even
connaissance	knowledge
honoré	honored
quatrième	fourth
m'appelle	call me
tombait	fell
l'émotion	the emotion
salué	welcomed
souvient	remember
saluer	greet
tendre	tender
visiblement	obviously
agitée	rough
tics	tics
quirrell	quirrell
présente	this
saisissant	entering
rencontrer	meet
enseignez	teach
défense	defence
vampires	vampires
terrifier	terrify
accaparer	grab
peines	sentences
l'entraîna	the led
entourée	surrounded
t'avais	you had
remarque	note
n'arrête	never stops
remarquable	remarkable
étudiait	studying
harpies	harpies
compta	accounting
brique	brick
trembloter	flicker
s'élargit	widens
arcade	arcade
permettre	allow
au-delà	beyond
pavée	paved
serpentait	meandered
perte	loss
stupéfaction	amazement
franchirent	crossed
l'arcade	the arcade
passage	passage
étalage	display
chaudrons	pots
pancarte	sign
annonçait	announced
tailles	sizes
touillage	touillage
modèles	models
pliables	foldable
falloir	take
demi-douzaine	a half-dozen
d'yeux	eyes
étals	stalls
faisaient	were
rondelette	penny
vitrine	showcase
apothicaire	apothecary
hochant	nodding
dix-sept	seventeen
mornilles	mornilles
grammes	grams
foie	liver
folie	madness
marmonna-t-	mumbled to himself
hululement	howling
l'enseigne	the sign
royaume	kingdom
hulottes	wood owls
chouettes	owls
effraies	owls
ducs	dukes
lapones	lapland
garçons	boys
l'âge	the age
nimbus	nimbus
2000	2000
télescopes	telescopes
foies	livers
chauve-souris	bat
d'anguille	eel
conservés	kept
barils	barrels
piles	batteries
plumes	feathers
parchemins	scrolls
globes	globes
lunaires	lunar
bâtiment	building
blancheur	whiteness
neige	snow
dominait	dominated
alentour	around
portail	portal
étincelant	sparkling
écarlate	scarlet
gobelin	goblin
marches	steps
blanche	white
menaient	led
intelligent	smart
fins	for
lorsqu'ils	when they
pénétrèrent	penetrated
s'inclina	bowed
retrouvèrent	found
gravés	engraved
étranger	foreign
désir	desire
l'appât	the bait
gain	gain
renonce	waives
obéir	obey
gagner	win
cupidité	greed
t'emparer	take
souterrain	underground
trésor	treasure
convoité	coveted
tien	tien
voleur	thief
trouveras	find
richesse	wealth
juste	just
châtiment	punishment
hardiesse	boldness
s'inclinèrent	bowed their heads
vaste	wide
marbre	marble
tabourets	stools
écrivant	writing
registres	records
pesant	weighing
balances	scales
examinant	examining
pierres	stones
précieuses	precious
loupe	magnifying glass
aménagées	furnished
d'essayer	try
compter	from
s'ouvraient	opened
escortés	escorted
s'approchèrent	came
coffre	safety deposit box
vider	empty
répandant	spreading
biscuits	biscuits
moisis	moldy
comptes	accounts
vous-savez-quoi	you-know-what
examina	examined
attentivement	carefully
accompagner	accompany
gripsec	gripsec
affaire	case
concerne	for
menés	conducted
étroit	close
éclairé	informed
torches	torches
pente	slope
voie	way
ferrée	railway
courait	ran
wagonnet	car
grimpés	climbed
emporta	took
d'abord	first
parcoururent	ran
labyrinthe	maze
galeries	galleries
tortueuses	winding
cesse	stops
droite	right
manœuvrer	maneuver
ouvrait	opened
bref	brief
flammes	flames
galerie	gallery
bifurqué	bifurcated
s'enfoncèrent	went
profondeurs	depths
longèrent	past
bordé	lined
stalactites	stalactites
stalagmites	stalagmites
j'oublie	I forget
stalactite	stalactite
stalagmite	stalagmite
couvrir	cover
verdâtre	greenish
s'appuyer	support
tremblants	trembling
rend	makes
voyager	travel
sourde	deaf
panache	plume
dissipé	dispelled
monceaux	heaps
s'entassaient	there was a pile
t'appartient	belongs to you
reprocher	blame
coûter	cost
fortune	fortune
l'attendait	the expected
sous-	sub-
sols	soil
aida	aida
celles	those
gallions	galleons
expliqua-t-il	he explained
dix-	ten-
gallion	gallion
vingt-neuf	twenty-nine
mornifle	mornifle
retenir	remember
scolaire	school
plaît	please
ajouta-t-il	he added
vitesse	speed
wagonnets	cars
réglable	adjustable
s'enfonçant	sinking
entrailles	bowels
température	temperature
glaciale	icy
virages	turns
angle	angle
ravin	ravine
scruter	scan
ramena	brought back
reculez	back
important	important
volatilisée	crumbled
d'ouvrir	open
aspiré	sucked
deviendrait	would
vérifiez	check
protégée	protected
contenir	contain
fabuleux	fabulous
déçu	disappointed
constater	see
grossièrement	coarsely
fourra	stuffed
curiosité	curiosity
renonça	gave up
certainement	certainly
disposé	willing
retourne	returns
infernal	infernal
Évite	Avoids
garde	guard
fermée	closed
endiablée	furious
éclatant	bright
cligner	blink
dépenser	spend
importait	importance
combien	how
valaient	worth
sterling	sterling
riche	rich
disposition	available
s'occuper	care
guipure	guipure
prêt-à-porter	ready-to-wear
t'ennuie	you mind
rejoins	join
remontant	going back
intimidé	intimidated
replète	replète
vêtue	dressed
mauve	purple
tabouret	stool
ajustait	adjusted
revêtue	coated
installa	installed
d'épingler	pin
l'ourlet	the hem
longueur	length
salut	hi
m'acheter	buy me
allée	alley
traînante	shuffling
n'auraient	would
j'arriverai	I'll get there
m'arrangerai	I will try
douce	soft
l'écoutant	listening to it
poursuivi-t-il	continued-t-he
quidditch	quidditch
sélectionné	selected
l'équipe	the team
serpentard	slytherin
t'imagines	saw
poufsouffle	hufflepuff
préférerais	would prefer
mmmh	mmmm
pertinente	relevant
crèmes	creams
glacées	ice
travaille	works
domestique	home
précisa	said
d'antipathie	antipathy
habite	live
parc	park
soûle	drunk
ivre	drunk
essaye	try
trouve	find
froideur	coldness
ricana	o
exclusivement	exclusively
réservé	reserved
viennent	come
éducation	education
rends	give
accepter	accept
issus	from
t'appelles	you call
interrompit	interrupted
l'occasion	the opportunity
terme	term
sauta	jumped
reverrons	again
mangeait	ate
chocolat-fraise	chocolate-strawberry
noisettes	hazelnuts
achetée	purchased
mentit	lied
s'arrêtèrent	stopped
découvrir	discover
vampire	vampire
n'es	no es
moldue	moldue
admis	admitted
appartient	belongs
meilleurs	best
lignée	lineage
exemple	example
passionnés	passionate
balles	balls
joueurs	players
expliquer	explain
maisons	houses
cancres	cancres
j'irai	I will go
passés	past
fleury	fleury
bott	bott
scolaires	school
pavés	pavers
reliés	related
timbre-poste	postage stamp
soie	silk
remplis	filled
symboles	symbols
blanches	white
traîner	hanging out
l'arracher	the snatch
contre-sorts	counter-spells
ensorcelez	ensorcelez
amis	friends
stupéfiez	stun
ennemis	enemies
sortilèges	spells
l'âne	the ass
jambencoton	jambencoton
plomb	lead
vindictus	vindictus
viridian	viridian
explique	explains
d'utiliser	use
exceptionnels	exceptional
façons	ways
apprendre	learn
permission	permission
l'acquisition	the acquisition
pliable	foldable
jolie	pretty
peser	weigh
ingrédients	ingredients
entrant	incoming
composition	composition
l'apothicaire	the apothecary
fascina	fascinated
dépit	despite
mélange	mix
pourris	rotten
choux	cabbage
avariés	spoiled
tonneaux	barrels
contenant	containing
substances	substances
gluantes	sticky
disposés	willing
bocaux	jars
d'herbes	herbs
racines	roots
séchées	dried
poudres	powders
brillantes	brilliant
d'oiseaux	birds
crochets	hooks
serres	greenhouses
pendaient	hung
base	base
fabrication	manufacturing
cornes	horns
argentées	silver
licornes	unicorns
continuèrent	continued
emplettes	shop
t'offre	offers you
ajouta	added
rougir	blush
n'êtes	there are
t'offrir	offer you
animal	animal
moquerait	laugh
éternuer	sneeze
veulent	want to
magnifique	beautiful
chouette	owl
paisiblement	peacefully
l'aile	the wing
bégayait	stuttered
reconnaissance	recognition
bourru	gruff
ollivander	ollivander's
étroite	close
délabrée	dilapidated
écaillées	shelled
indiquaient	indicated
fabricants	manufacturers
poussiéreuse	dusty
exposée	exposed
coussin	cushion
râpé	grated
entrée	entry
clochette	bell
réservée	reserved
assit	sat
d'entrer	to enter
austère	austere
venaient	came
milliers	thousands
boîtes	boxes
étroites	narrow
nuque	neck
poussière	dust
receler	harbour
secrète	secret
pâles	pale
lunes	moons
souviens	remember
centimètres	centimeters
souple	flexible
saule	willow
excellente	excellent
argentés	silver
d'angoissant	scary
d'acajou	mahogany
flexible	flexible
puissante	powerful
remarquablement	remarkably
efficace	effective
métamorphoses	metamorphoses
choisit	chooses
maître	master
touchaient	touched
blanc	white
toucha	touched
vendu	sold
d'if	if
maléfiques	evil
chêne	oak
exclu	excluded
grave	serious
gardé	kept
assurée	insured
servez	use
interrogea	asked
crispées	tense
mmmmmm	mmmmmm
revenons	let's go back
mètre	meter
ruban	ribbon
marques	brands
tenez-vous	hold you
droitier	right-handed
tendez	stretch
mesura	measured
coude	elbow
hauteur	height
jusqu'aux	up to
l'aisselle	the armpit
renferme	contains
puissantes	powerful
utilisons	use
poil	hair
licorne	unicorn
phénix	phoenix
ventricules	ventricles
semblables	similar
n'existe	there is
identiques	identical
j'ajoute	I add
qu'aucune	no
résultats	results
satisfaisants	satisfactory
nôtres	ours
disposées	arranged
mesures	measures
l'écartement	the spacing
narines	nostrils
notamment	in particular
essayez	try
hêtre	beech
contient	contains
ventricule	ventricle
prenez-la	take the
agitez-la	shake the
d'érable	maple
l'essaya	tried
d'ébène	ebony
crin	horsehair
allez-y	go for it
posées	asked
convenait	should
commenta	commented
satisfait	satisfied
finirons	finish
convient	should be
combinaison	combination
originale	original
houx	holly
manier	handle
l'abaissa	the lowered
siffler	whistle
gerbe	sheaf
d'étincelles	sparks
jaillit	springs
l'extrémité	the end
mouvantes	moving
applaudit	cheers
enthousiaste	enthusiastic
bravo	bravo
etrange	strange
enveloppa	wrapped
continuant	continuing
marmonner	mumble
excusez-moi	excuse me
fixa	fixa
vendue	sold
répondit-il	he replied
prélevée	taken
fourni	provided
précisément	precisely
convenu	agreed
curieux	curious
produisent	produce
souvenez-vous	remember
avenir	future
celui-dont-on-ne-	he-who-we-do-
doit-pas-prononcer-le-nom	must-not-pronounce-the-name
grandes	large
certes	of course
envergure	scale
frissonna	shivered
d'éprouver	experience
paya	paya
coûtait	cost
raccompagna	raccompagna
reprirent	resumed
descendait	down
l'horizon	the horizon
inverse	reverse
traversèrent	crossed
formes	forms
somnolait	was dozing
mécanique	mechanical
paddington	paddington
fallut	took
tapote	pats
réalise	performs
départ	starting
hamburger	hamburger
plastique	plastic
s'expliquer	explain
d'exceptionnel	exceptional
mâchonnant	munching
viande	meat
caoutchouteuse	rubbery
connais	know
peuvent-ils	can they
rappelle	remember
bienveillant	benevolent
apprendras	learn
toi-même	yourself
choisi	chosen
accompagna	accompanied
king's	king's
cross	cross
envoie-moi	send me
s'ébranla	will shook
siège	seat
colla	colla
rendez-vous	appointment
mois	months
forçaient	forced
réprimandaient	réprimandaient
qu'avant	as before
déprimant	depressing
baptisée	called
hedwige	hedwig
journées	days
qu'hedwige	that hedwig
rentrant	returning
ménage	household
cadavres	corpses
soirs	night
barrait	gone
calendrier	calendar
accroché	hung
toussota	toussota
signaler	report
indiquer	indicate
sois	am
voudrais	would like to
tapis	carpet
trouve-t-elle	does it
conscience	consciousness
ignorance	ignorance
l'observèrent	the observed
fous	crazy
décréta	decreed
devais	had to
j'emmène	I take
l'hôpital	the hospital
enlever	remove
jean	jean
revêtant	since
changerait	change
vérifia	verified
enfermée	locked
réveillent	wake up
chargea	charged
valise	suitcase
prirent	took
chariot	cart
voies	pathways
tienne	yours
construite	built
chiffre	figure
quais	docks
repartit	left
ajouter	add
sèche	dry
intriguait	intrigued
voyageurs	travelers
employé	employee
destination	destination
région	region
situé	located
l'employé	the employee
s'énerva	got mad
croyant	believing
partait	left
qu'aucun	no
heure-là	time
maudissant	cursing
céder	assign
horloge	clock
tableau	table
arrivées	arrivals
indiqua	said
monter	mount
soulever	lift
d'important	important
tapé	typed
pénétrer	enter
tapoter	tap
composteur	composter
roux	roux
flamboyants	flamboyant
poussait	pushing
placer	place
décida	decided
fillette	girl
rousse	redhead
ginny	ginny
vas-y	vas-y
percy	percy
passe	pass
l'aîné	the elder
dirigea	led
l'observa	the observed
touristes	tourists
touriste	tourist
fred	fred
george	george
franchement	frankly
digne	worthy
confondre	confused
désolée	sorry
frère	brother
jumeau	twin
dépêcher	hurry
volatilisa	dissolved
comprenne	understand
dadais	greenhorn
taches	spots
rousseur	freckles
barrière	barrier
tourniquets	turnstiles
t'arrête	stop
n'aie	don
trac	trac
solide	solid
hâtaient	hâtaient
penché	leaning
courir	run
rapprochait	close
dangereusement	dangerously
freiner	curb
cinquante	fifty
ferma	closed
obstacle	obstacle
rouvrit	reopened
locomotive	locomotive
pressait	pressed
compacte	compact
signalait	reported
express	express
arche	ark
forgé	forged
s'échappait	escaped
glissaient	slide
ponctuée	punctuated
valises	suitcases
traînées	streaks
ululements	ululements
grognon	grumpy
wagons	cars
pleins	full
d'élèves	students
penchés	looked
bavardaient	chatted
battaient	fighting
recherche	search
libre	free
joufflu	chubby
grand-mère	grand-mother
neville	neville
dame	lady
dreadlocks	dreadlocks
montre-nous	show us
souleva	raised
surgir	arise
longe	along
velue	hairy
fraya	fraya
wagon	car
compartiment	compartment
d'hedwige	of hedwig
hisser	hoist
marchepied	footstool
t'aider	help
suivis	followed
s'installer	install
relevant	under
mèche	wick
trempés	soaked
sueur	sweat
chœur	chorus
frères	brothers
m'man	me man
hâtèrent	hurried
redescendre	down
demi-caché	half-hidden
dérober	steal
l'attrapa	caught
frotter	rub
laisse-moi	let me
dégager	release
ferme-la	farm-the
démarche	approach
revêtu	coated
épinglé	pinned
insigne	badge
l'avant	the front
préfets	prefects
préfet	prefect
aurais	would have
prévenir	prevent
soufflé	blown
rappelles	remember
l'été	the summer
réfléchir	think
émue	moved
embrassa	kissed
sages	wise
lança-t-elle	"she
reçois	get
occupez-vous	do you
n'aura	will
craindre	fear
frotté	rubbed
devine	guess
vient	comes
blottit	nestled
voient	see
brun	brown
flûtée	the flute-like
l'as	the ace
curieuse	curious
poli	polished
qu'avait	that was
t'interdis	forbid you
d'école	school
sifflet	whistle
dépêchez-vous	hurry up
t'enverra	will send you
s'indigna	grew indignant
pleurant	crying
riant	laughing
bordaient	lined
défilaient	marching
sentiment	feeling
d'excitation	excitation
s'ouvrit	opened
compartiments	compartments
indifférent	indifferent
tache	spot
jordan	jordan
tarentule	tarantula
présentés	presented
weasley	weasley
refermé	closed
confirma	confirmed
m'étais	I was
blague	joke
avidement	eagerly
éblouissante	dazzling
s'intéressait	if interested
paraît	seems
comptable	accounting
parle	speaks
gens-	people-
horribles	horrible
abominables	abominable
rectifia	modified
assombri	clouded
sixième	sixth
intérêt	interest
bill	bill
charlie	charlie
aînés	seniors
capitaine	captain
chargé	loaded
maintenir	maintain
discipline	discipline
pion	pawn
confessa	confessed
apercevra	notice
serai	am
trouvera	find
croûtard	croûtard
dort	sleeps
moyens	means
oreilles	ears
devinrent	became
écarlates	scarlet
détourna	away
honteux	shameful
l'annonce	the announcement
prononcé	pronounced
choqué	shocked
admirait	admired
rassurant	reassuring
apprennent	learn
vaches	cows
moutons	sheep
paissaient	grazed
prés	meadows
midi	midi
demi	half
tintinnabuler	tintinnabuler
désirez	want to
marchandises	goods
sandwiches	sandwiches
barres	bars
plairait	would like
friandises	treats
s'aperçut	saw
totalement	totally
inconnues	unknown
dragées	dragees
surprises	surprises
bertie	bertie
crochue	crooked
ballongommes	ballongommes
bullard	bullard
chocogrenouilles	chocolate frog
patacitrouilles	patacitrouilles
fondants	fluxes
réglisse	licorice
manquer	miss
acheta	bought
acquisitions	acquisitions
étala	spread
banquette	bench
affamé	hungry
mordant	biting
patacitrouille	patacitrouille
oublie	forget
corned-beef	corned beef
soupira-t-il	he sighed
l'échange	the exchange
plaira	please
sers-toi	sers-toi
proposa	proposed
partager	share
grenouilles	frogs
collection	collection
agrippa	agrippa
chocogrenouille	chocogrenouille
cents	cents
ptolémée	ptolemy
aquilin	aquiline
chevelure	hair
portrait	portrait
passe-moi	pass me
trouverai	find
actuel	current
college	college
considéré	considered
modernes	modern
écrasant	crushing
1945	1945
mage	mage
grindelwald	grindelwald
travailla	worked
collaboration	collaboration
l'alchimiste	the alchemist
nicolas	nicolas
flamel	flamel
découverte	discovery
propriétés	properties
sang	blood
bowling	bowling
musique	music
stupéfait	stunned
s'écria-t-il	cried it
tombé	fallen
morgane	morgane
pourras	can
pile	battery
attendaient	waiting
restent	remain
vont	go
étonné	surprised
portraits	portraits
hengist	hengist
woodcroft	woodcroft
d'alberic	of alberic
grunnion	grunnion
circé	circe
paracelse	paracelsus
s'arracha	tore itself away
contemplation	contemplation
druidesse	druidesse
cliodna	cliodna
grattait	scratched
sachet	bag
trucs-là	stuff
parfums	perfumes
tombe	falls
épinards	spinach
tripes	tripe
dragée	dragee
l'examina	the examined
mordit	bit
beuârk	beuârk
s'exclama-t-il	exclaimed,-t-he
bruxelles	brussels
s'amusèrent	chic
divers	various
toast	toast
grillé	grilled
coco	coco
haricots	beans
blancs	white
fraise	strawberry
curry	curry
gazon	turf
café	coffee
sardine	sardine
goûter	taste
grise	grey
toucher	touch
poivre	pepper
traversé	crossed
paysages	landscapes
campagne	campaign
champs	fields
dessinés	drawn
abordait	addressed
forêts	forests
collines	hills
rivières	rivers
serpentaient	snaked
arbres	trees
n'auriez	would
lamenta	lamented
s'échapper	escape
accablé	overwhelmed
s'inquiète	is concerned
continué	continued
verrait	would
fouilla	fumbled
abîmée	damaged
extrémité	end
brandissait	wielding
accompagné	accompanied
sien	his
bruns	brown
ébouriffés	tousled
autoritaire	authoritarian
l'écoutait	listened to it
dépourvu	devoid
jonquille	daffodil
colorié	colored
agita	agita
produisit	produced
appelles	call
m'entraîner	train me
recevant	receiving
contente	happy
programme	program
suffisant	sufficient
débuter	start
hermione	hermione
granger	granger
soulagé	relieved
expression	expression
stupéfaite	stunned
culture	culture
générale	general
moderne	modern
grandeur	size
décadence	decadence
evénements	events
siècle	century
serez	will be
gryffondor	gryffindor
serdaigle	ravenclaw
doivent	must
feriez	would
tarder	delay
emmenant	taking
abandonné	abandoned
rangeant	ranking
sortilège	hex
divisée	divided
répartis	spread
selon	according to
personnalité	personality
s'assombrit	darkens
diront	tell
retrouvais	found
mettent	put
démoraliser	demoralize
dirait	looks like
moustaches	whiskers
diplômes	diplomas
roumanie	romania
recherches	research
afrique	africa
propos	about
article	article
voleurs	thieves
expert	expert
s'introduire	enter
emporté	away
d'apprendre	to learn
crainte	fear
conséquence	result
s'inquiéter	worry
équipe	team
équipes	teams
avoua	admitted
règles	rules
postes	posts
occupés	occupied
matches	matches
décrivit	described
aspects	aspects
complexes	complex
reconnut	recognized
d'intérêt	interest
lors	when
rencontre	meeting
solidement	securely
bâtis	built
gardes	guards
crabbe	crabbe
goyle	goyle
malefoy	malfoy
drago	drago
toux	cough
discrète	discreet
ricanement	sneer
d'enfants	children
nourrir	feed
fréquentes	frequent
douteux	doubtful
conseils	tips
rosirent	rosirent
prudent	careful
prudence	caution
trames	frames
racaille	guy
déteindre	bleed
répète	repeat
filer	spinning
paraître	look
assuré	insured
l'était	the was
gars	guys
adversaire	opponent
pointues	sharp
plantées	planted
phalange	phalanx
reculèrent	went back
lâcher	letting go
prise	outlet
projeté	projected
s'éclipsèrent	slipped away
craignant	fearing
cachés	hidden
étalées	plated
assommé	knocked out
rendormi	back to sleep
prétendu	alleged
victimes	victims
croit	believes
machiniste	machinist
étions	were
battus	beaten
cherchez	looking for
battu	beat
t'ennuierait	you bother
change	exchange
hautain	haughty
courent	run
saleté	dirt
sortait	out
enfilèrent	enfilèrent
courte	short
arriverons	get
bagages	luggage
acheminés	routed
séparément	separately
locaux	local
estomac	stomach
contracter	contract
pâlir	fade
rempli	filled
restaient	remained
rejoignirent	joined
pressaient	pressed
frissonner	shiver
lampe	lamp
balança	swung
familière	familiar
suivez-moi	follow me
rayonnant	radiant
faites	do
mettez	put
escarpé	steep
s'enfonçait	sinking
devaient	had to
apercevoir	see
prochain	next
oooooh	oooooh
l'étroit	the narrow
débouché	outlet
rive	shore
perché	perched
immense	huge
château	castle
hérissé	spiky
étoilé	starry
flotte	fleet
canots	canoes
alignés	aligned
casé	fitted
monté	mounted
barques	boats
glissèrent	glissèrent
lisse	smooth
dressé	upright
falaise	cliff
baissez	lower
atteignirent	reached
paroi	wall
abrupte	steep
s'exécuta	did it
franchissaient	crossed
rideau	curtain
lierre	ivy
ouverture	opening
taillée	cut
bateaux	boats
emportèrent	took
tunnel	tunnel
mener	lead
crique	creek
souterraine	underground
débarquèrent	landed
rocheux	rocky
trevor	trevor
guidés	guided
grimpèrent	climbed up
creusé	dug
pelouse	lawn
s'étendait	extended
l'ombre	the shadow
volée	fly
pressèrent	crowded
choixpeau	sorting hat
contrarier	upset
annonça	announced
l'apercevoir	see
enflammées	inflamed
fixées	set
somptueux	sumptuous
permettait	allowed
dallé	paved
parvenaient	could
située	located
l'exiguïté	the small size
obligea	forced
inquiets	worried
banquet	banquet
début	beginning
d'année	of the year
preniez	take
partition	partition
constitue	is
cérémonie	ceremony
devez	must
séjour	stay
seconde	second
suivrez	follow
dormirez	sleep
dortoir	dormitory
passerez	pass
commune	common
chacune	each
formé	formed
obtiendrez	get
bons	good
rapporterez	bring it back
enfreindrez	breach
communes	common
perdra	lose
obtenu	obtained
gagnera	will win
répartition	distribution
conseille	advises
soigner	treat
tenue	held
s'attarda	lingered
fébrile	febrile
d'aplatir	flatten
reviendrai	will come back
attendez-	wait-
serrée	tight
font-ils	do they
sélectionner	select
tests	tests
haut-le-corps	top-the-body
chuchotait	whispering
possibles	possible
appréhension	apprehension
rapporter	report
carnet	book
mystérieusement	mysteriously
bleu	blue
soupçonnait	suspected
gardait	kept
destin	destiny
fatal	fatal
s'élevèrent	rose
fantômes	ghosts
d'apparaître	to appear
traversant	crossing
nacré	mother-of-pearl
transparents	transparent
paraissaient	seemed
disputer	play
moine	monk
oublions	forget
pardonnons	forgive
devrions	should
n'avons-nous	have we
peeves	peeves
chances	chances
méritait	deserved
spectre	spectrum
hauts-de-chausse	hauts-de-chausse
fantôme	ghost
qu'est-	that is-
gardèrent	kept
souriant	smiling
attendez	wait
hochèrent	shook
brusque	sudden
quittèrent	left
opposé	opposite
mettez-vous	put yourself
rang	rank
changées	changed
franchit	crosses
double	double
chandelles	candles
suspendues	suspended
éclairaient	illuminated
longues	long
tables	tables
desquelles	which
gobelets	cups
aligna	aligna
lesquels	which
clarté	clarity
incertaine	uncertain
visages	faces
observaient	watched
telles	such
lanternes	lanterns
dispersés	scattered
panaches	plumes
gêné	embarrassed
velours	velvet
parsemé	dotted
ressembler	look like
rapiécé	patched
allait-on	would it be
lapin	rabbit
régna	reigned
total	total
remua	stir
déchirure	tear
chanter	sing
n'suis	does am
beauté	beauty
s'fier	be proud
voit	see
trouvez	find
qu'moi	that to me
hauts-d'forme	high-form
chapeaux	hats
splendides	splendid
pâl'figure	pâl'figure
soumet	submit
choix	choice
m'échapp'rien	I échapp'nothing
m'arrête	stop me
mettez-moi	put me
rejoindrez	join
hardis	hardy
forts	strong
s'rez	if the ground
loyal	fair
aiment	love
patience	patience
proverbiale	proverbial
accueillera	welcome
érudits	scholars
finirez	'll end up
vrais	true
roublards	misfits
parviennent	manage
pose-moi	raises me
serein	serene
chanson	song
applaudissements	applause
éclatèrent	burst
m'avait	I had
troll	troll
l'impressionnait	the impressed
existé	existed
nausée	nausea
tenant	taking into
j'appellerai	I will call
mettrez	will
assiérez	sit
abbot	abbot
hannah	hannah
nattes	mats
blondes	blondes
acclamations	cheers
asseoir	sit
enthousiastes	enthusiastic
bones	bones
susan	susan
d'hannah	hannah
boot	boot
terry	terry
appela	called
accueillirent	welcomed
brocklehurst	brocklehurst
mandy	mandy
envoyée	sent
brown	brown
lavande	lavender
ovation	ovation
l'extrême	the extreme
arrivée	arrival
bulstrode	bulstrode
millicent	millicent
éprouva	felt
séances	sessions
lesquelles	which
composait	included
sportives	sports
ancienne	old
risque	risk
manifester	show
finch-fletchey	finch-fletchey
justin	justin
réflexion	reflection
décider	decide
enfonça	stuck
frénétiquement	frantically
accompagnent	accompany
états	states
finisse	finish
annoncer	announce
rentrer	return
londubat	londubat
trébucha	stumbled
s'approchant	approaching
macdougal	macdougal
morag	morag
éclats	shards
conquérant	conqueror
frôlé	brushed
mine	mine
satisfaite	satisfied
envoyés	sent
sympathique	friendly
moon	moon
nott	nott
parkinson	parkinson's
jumelles	binoculars
patil	patil
perks	perks
sally-anne	sally-anne
plongeant	plunging
absolu	absolute
têtes	heads
tendaient	tended
oreille	ear
qualités	qualities
intellectuelles	intellectual
talent	talent
preuves	evidence
intéressant	interesting
vais-je	will I
crispa	crispa
bords	edges
pensa-t-il	he thought
d'immenses	huge
sais-tu	do you know
t'aiderait	you would help
t'envoyer	send you
résonner	resonate
échappé	escaped
réservait	reserved
bruyante	noisy
soirée	evening
vigoureusement	vigorously
scandaient	chanted
amicalement	friendly
l'horrible	the horrible
seau	bucket
glacée	ice
extrémités	ends
pouce	inch
centre	centre
trônait	sat
grâce	thanks
trouvée	found
d'éclat	flash
émotif	emotional
turban	turban
répartir	divide
turpin	turpin
lisa	lisa
croisa	crossed
pompeux	pompous
zabini	zabini
blaise	blaise
envoyé	sent
désespérément	desperately
largement	widely
nigaud	little fool
grasdouble	grasdouble
pinçon	pinçon
remercie	thank
applaudissait	applauded
léger	lightweight
génie	engineering
pommes	apples
plats	dishes
débordaient	outside
victuailles	food
roast-beef	roast beef
poulet	chicken
côtelettes	chops
porc	pork
d'agneau	lamb
steaks	steaks
gratin	gratin
terres	land
sautées	sautéed
frites	French fries
légumes	vegetables
sauces	sauces
onctueuses	creamy
ketchup	ketchup
nourriture	food
précipitait	rush
rendait	made
remplit	fills
appétit	appetite
appétissant	appetizing
trancher	slice
steak	steak
nicholas	nicholas
mimsy	mimsy
porpington	porpington
résident	resident
nick	nick
quasi-sans-tête	quasi-without-head
l'interrompit	the interrupted
seamus	seamus
finnigan	finnigan
peut-on	can we
quasi	almost
offensé	offended
déroulait	place
vœux	best wishes
ceci	this
bascula	tilt
épaule	shoulder
rattachée	attached
charnière	hinge
décapiter	decapitate
terminer	finish
ébahis	amazed
aider	help
obtenue	obtained
remportée	won
baron	baron
sanglant	bloody
insupportable	unbearable
prétention	claim
émacié	emaciated
maculés	stained
reflets	reflections
satisfaction	satisfaction
enchanté	enchanted
d'occuper	to occupy
a-t-il	there
couvert	covered
délicatesse	delicacy
l'estomac	the stomach
vaisselle	dishes
étincelante	sparkling
propreté	cleanliness
dessert	dessert
tartes	pies
éclairs	lightning
beignets	donuts
babas	babas
fraises	strawberries
tarte	pie
mélasse	molasses
moitié-moitié	half-and-half
expliqua	explained
élevé	high
algie	algie
grand-oncle	great-uncle
jetée	pier
blackpool	blackpool
noyer	walnut
chevilles	ankles
amusé	amused
pendre	hang
grand-tante	great-aunt
enid	enid
meringue	meringue
lâché	let go
rebondi	bounced
jusque	until
doué	gifted
m'accepte	accepts me
m'intéresse	I am interested
passionnant	exciting
parait	seems
faudra	will
allumette	match
aiguille	needle
vidait	emptied
gobelet	cup
bavardait	chatted
collègues	colleagues
cireux	waxy
celui-	the
ressentit	felt
aiguë	acute
fulgurante	dazzling
plaquant	plating
s'inquiéta	if worry
éprouvée	proven
croisant	crossing
l'aimait	loved it
prof	prof
rogue	rogue
rayon	radius
observa	watched
desserts	desserts
rassasié	full
étanché	quenched
soif	thirst
règlement	regulation
intérieur	inside
interdit	prohibited
exception	exception
entoure	surrounds
anciens	old
feraient	would
étincelants	sparkling
rusard	rusard
concierge	concierge
couloirs	corridors
sélection	selection
souhaitent	wish
bibine	booze
avertir	warn
l'accès	access
formellement	formally
teniez	keep
d'atroces	atrocious
souffrances	suffering
imité	imitated
remplie	filled
bêtes	beasts
chantons	sing
ensemble	all
l'hymne	the anthem
figé	frozen
mouche	fly
échappa	escaped
tortillant	wiggling
former	form
paroles	lyrics
chantera	sing
apprends-nous	teach us
guimauve	marshmallow
migraine	migraine
d'âne	ass
mijote	simmers
crânes	skulls
oblige-nous	requires-we
répète-nous	repeat-we
c'qu'on	this one
surpasse	surpasses
c'que	it that
cerveaux	brains
crient	shout
termina	finished
moments	moments
rythme	pace
marche	walking
funèbre	funeral
choisie	chosen
marqua	marked
cadence	cadence
applaudirent	cheered
s'essuyant	wiping
pourrons	can
suivirent	followed
fatigue	fatigue
plantureux	buxom
repas	meal
personnages	characters
tableaux	tables
accrochés	hung
chuchoter	whisper
cachées	hidden
tapisseries	tapestries
panneaux	panels
coulissants	sliding
interminable	endless
cannes	cannes
apparurent	appeared
flottant	floating
ruèrent	were
frappeur	batting
montre-toi	show yourself
élevant	raising
grossier	coarse
résonna	rang
j'aille	I go
méchant	nasty
dessina	drew
croisées	cross
cramponnait	hanging
ooooooooh	ooooooooh
accompagnant	accompanying
caquètement	chatter
fondit	burst
obligeant	forcing
baisser	lower
plaisante	pleasant
laissant	leaving
armures	armor
cliquetèrent	cliquetèrent
poursuivant	continuing
obéisse	obey
écoute	listening
caput	caput
draconis	draconis
pivota	swung
rond	round
découpé	cut
engouffrèrent	engouffrèrent
ronde	round
confortable	comfortable
accueillante	welcoming
fauteuils	chairs
moelleux	fluffy
dortoirs	dormitories
réservés	reserved
filles	girls
colimaçon	spiral
trouvèrent	found
baldaquin	canopy
rideaux	curtains
amenées	brought
fatigués	tired
pyjama	pajamas
hein	eh
ronger	gnaw
voulut	wanted
copieux	rich
transférer	transfer
lourd	heavy
l'enlever	remove
serrait	tightened
douloureusement	painfully
riait	laughed
s'escrimer	if escrimer
vain	vain
l'apparence	the appearance
type	type
quitté	left
murmurer	whisper
salles	rooms
revenaient	returned
croiser	cross
quarante-deux	forty-two
escaliers	stairs
larges	large
étroits	close
courbes	curves
carrés	square
délabrés	dilapidated
escamotables	retractable
d'enjamber	step-over
s'ouvrir	open
poliment	politely
chatouillait	tickled
pans	pans
déguisés	disguised
bougeait	moved
représentés	represented
persuadé	persuaded
promenaient	walking
facilitaient	facilitated
l'ouvrir	the open
d'aider	help
bombardait	bombarded
craie	chalk
tirait	drew
renversait	reversed
corbeilles	baskets
glissait	glided
silencieusement	silently
attrapait	caught
toutefois	however
argus	argus
essayaient	tried
malchance	bad luck
révélée	revealed
refusé	refused
perdus	lost
menacés	threatened
enfermer	lock
cachot	dungeon
secours	relief
chatte	pussy
miss	miss
teigne	ringworm
créature	creature
décharnée	gaunt
globuleux	globose
lampes	lamps
l'image	the image
sillonnait	crisscrossed
commettre	commit
faute	fault
orteil	toe
interdite	prohibited
filait	spinning
accourait	hasten to
soufflant	blowing
bœuf	beef
passages	passages
lorsqu'on	when
l'exercice	the year
consistait	was
brandir	brandish
marmonnant	mumbling
mercredi	Wednesday
apprenaient	learning
étudiaient	studying
plantes	plants
situées	located
joliment	nicely
potelée	chubby
chourave	chourave
ennuyeux	boring
d'histoire	history
enseignée	taught
binns	binns
monocorde	monotonous
griffonnaient	griffonnaient
confondant	confusing
emerie	emerie
hargneux	surly
ulric	ulric
follingue	follingue
flitwick	flitwick
d'enchantements	enchantments
l'appel	the call
renverse	reverses
différente	different
stricte	strict
intelligente	smart
directement	directly
aurez	will
chahut	ruckus
interdiction	ban
prévenus	defendants
redonné	given
d'origine	original
démonstration	demonstration
impressionnante	impressive
explications	explanations
compliquées	complicated
s'exercer	exercise
l'allumette	the match
devenue	become
pointue	sharp
accordé	granted
rares	rare
impatience	impatience
l'enseignement	education
imprégnée	impregnated
d'ail	garlic
destiné	for
éloigner	away
craignait	feared
prince	prince
africain	african
remercier	thank
débarrassé	free
zombie	zombie
sonnait	sounded
combattu	fought
permanence	permanently
constata	found
élevés	high
doutés	guessed
appartenaient	belonged
avantage	advantage
appartenance	membership
servi	served
avantager	benefit
verra	see
empêchée	prevented
devoirs	duties
tournoyaient	whirled
propriétaire	owner
mordiller	chew
grignoter	nibble
retourner	return
volière	aviary
voleter	fly
confiture	jam
sucrier	sugar
l'assiette	the plate
déchira	rent
griffonné	scribbled
réponds-moi	answer me
m'envoyant	sending me
emprunta	borrowed
écrivit	wrote
message	message
destinataire	recipient
baume	balm
épreuve	test
subir	undergo
trompé	wrong
haïssait	hated
cachots	dungeons
formol	formalin
effrayant	scary
pause	break
célébrité	celebrity
cachant	hiding
acheva	completed
science	science
subtile	subtle
l'art	the art
rigoureux	rigorous
préparation	preparation
élevée	high
murmure	whisper
effort	effort
s'amuse	fun
agiter	shake
m'attends	expect
compreniez	to understand
bouillonne	bubbles
volutes	volutes
scintillantes	sparkling
s'insinue	creeps
veines	veins
ensorceler	bewitch
emprisonner	imprison
gloire	glory
distiller	distiller
flacon	bottle
étiez	were
bandes	bands
cornichons	pickles
dispense	exemption
suivie	followed
échangèrent	exchanged
prouver	prove
cornichon	pickle
j'obtiens	I get
racine	root
d'asphodèle	asphodel
poudre	powder
infusion	infusion
d'armoise	wormwood
décontenancé	taken aback
d'hermione	of hermione
levée	lifting
boulet	boulet
rictus	grin
méprisant	despising
essayons	try
iriez-vous	would you go
demandais	wondering
bézoard	bézoard
secoués	shaken
n'alliez	go
exiger	require
retenu	retained
intitulé	title
frémissante	simmering
napel	napel
tue-loup	tue-loup
tendue	tense
qu'hermione	as hermione
rires	laughter
asseyez-vous	sit
information	information
donne	gives
somnifère	sleeping pill
l'appelle	the calls
goutte	drop
chèvres	goats
antidote	antidote
poisons	poisons
s'agit	is
plante	plant
d'aconit	of aconite
note	note
impertinence	impertinence
coûtera	cost
répartit	distributes
potion	potion
furoncles	boils
repassait	ironed
orties	nettles
écraser	crush
sévères	severe
critiques	critical
nuage	cloud
emplit	fills
fondre	melt
rongeant	gnawing
aspergé	sprinkled
gémissait	moaning
poussaient	grew
imbécile	fool
gronda	gronda
répandue	widespread
ajouté	added
épines	thorns
porc-épic	porcupine
retirer	remove
emmenez-le	take the
l'infirmerie	the infirmary
préparé	prepared
pensiez	thought
ratait	missed
injuste	unfair
répliquer	replicate
dissuader	deter
chuchota-t-il	whispered-t-he
remontèrent	went
remuait	stir-fried
moral	moral
haïssait-il	hated it
enlevait	removed
bordure	border
arbalète	crossbow
d'aboiements	barking
sonores	sound
domina	domina
crockdur	crockdur
l'entrebâillement	round
collier	necklace
molosse	mastiff
jambons	hams
faisans	pheasants
suspendus	suspended
recouvert	covered
courtepointe	quilt
patchwork	patchwork
lécher	lick
chaude	hot
l'envie	the desire
faillirent	almost
racontèrent	told
bavait	dribbled
abondamment	plenty
enchantés	enchanted
qualifier	qualify
ganache	ganache
présenter	present
j'entre	I
suit	following
impossible	impossible
d'elle	it
l'envoie	sends
hait	hates
insista	insisted
haïrait-il	hated it
détourné	hijacked
l'aimais	the loved
cambriolage	burglary
gringott's	gringott's
l'enquête	the survey
poursuit	continues
piste	track
enquêteurs	investigators
milieux	environments
répété	repeated
volé	stolen
fracturée	fractured
vidée	emptied
révélerons	reveal
conseillons	advise
vivement	strongly
mêler	mix
déclaré	said
porte-parole	spokesperson
tentative	attempt
précisé	specified
fuyait	leaked
biscuit	biscuit
relut	read
l'article	article
vidé	emptied
appeler	call
polis	polished
estima	estima
l'antipathie	the antipathy
manifestée	manifested
duel	duel
détestable	detestable
hélas	alas
d'affichage	display
informa	informa
communs	common
rêver	dream
n'attendais	did not expect
ridiculiser	ridicule
leçons	lessons
d'impatience	looking forward to
vante	boasts
joueur	player
coûte	costs
terrain	field
héros	hero
terminaient	finished
invariablement	invariably
poursuite	further
haletante	panting
l'issue	the outcome
échappait	escaped
justesse	accuracy
hélicoptère	helicopter
piloté	driven
vanter	boast
enfance	childhood
acrobaties	acrobatics
aériennes	air
collision	collision
deltaplane	hang gliding
pilotait	flying
dispute	dispute
dean	dean
thomas	thomas
partageait	shared
d'intéressant	interesting
affiche	displays
représentant	representative
west	west
songeait	was thinking of
décision	decision
d'accidents	accidents
restant	remaining
redoutait	feared
leçon	lesson
jeudi	Thursday
infligea	inflicted
trouvés	found
âges	ages
buvait	drank
l'espoir	hope
l'aider	the help
l'arrivée	the arrival
interrompe	interrupt
conférence	conference
apportait	brought
colis	package
jubilation	jubilation
apporta	brought
envoyait	sent
fébrilement	feverishly
boule	ball
bille	ball
rapeltout	rapeltout
étourdi	dizzy
devient	becomes
fronça	frowned
mécontents	unhappy
prétexte	excuse
accourut	ran
passe-t-il	happens
gémit	moans
retomber	fall
après-midi-là	afternoon
sortirent	went out
vastes	large
pelouses	lawns
balancer	swing
soigneusement	carefully
qualité	quality
vibrer	vibrate
tiraient	drew
courts	short
jaunes	yellow
faucon	falcon
aboya-t-elle	barked a-t-it
dites	tell
crièrent	cried
l'unisson	unison
chevaux	horses
tremblement	shake
clairement	clearly
enfourcher	ride
corriger	correct
donnez	give
lancer	launch
frappez	hit
tiendrez	hold
droits	rights
élèverez	elevate
mètres	meters
reviendrez	return
penchant	leaning
décoller	take off
redescends	'm going down
ordonna-t-elle	ordered it
bouchon	cap
champagne	champagne
décomposer	break down
s'élever	rise
dériva	drifted
penchée	leaning
murmura-t-elle	she whispered
lève-toi	lève-toi
bouge	moves
laissez	let
garantis	guaranteed
resterez	stay
ruisselant	dripping
clopina	clopina
mollasson	effete
tais-toi	tais-toi
parvati	parvati
pansy	pansy
aimais	loved
pleurnichards	whiners
l'herbe	the grass
donne-moi	give me
arbre	tree
enfourché	riding
décolla	took off
menti	lied
cime	crown
attirer	attract
flottait	floated
intense	intense
découvrant	discovering
naturel	natural
merveilleuse	wonderful
suivaient	followed
virage	turn
d'instinct	instinct
javelot	javelin
épingle	pin
sauver	save
mise	update
attrape	grabs
film	film
ralenti	idle
amorcer	boot
chute	fall
abaissa	lowered
fonçant	darkening
mêlaient	mixed
fendait	cracked
vertigineuse	dizzying
réussit	successful
cinquantaine	fifty
redresser	straighten
creux	hollow
lançaient	launched
rompre	break
taisez-vous	shut up, you
arboraient	wore
triomphant	triumphant
refusait	refused
tenu	view
verraient	would
arpentait	strode
l'emmenait-elle	him-it
renvoyer	return
pourrait-il	could it
assistant	wizard
nouer	build
condamné	sentenced
puis-je	can I
emprunter	borrow
bâton	stick
dubois	dubois
cinquième	fifth
entrez	enter
écrire	write
corbeille	trash
jurons	swearing
planta	planta
olivier	olivier
attrapeur	monkey net
ravissement	rapture
parlez	talk
sérieusement	seriously
montiez	mount
l'exclure	the exclude
descente	descent
quinze	fifteen
tiré	shot
égratignure	scratch
réaliser	make
assisté	assisted
match	match
l'examiner	the review
astiqueur	astiqueur
entorse	sprain
fournir	provide
littéralement	literally
écrasés	crushed
severus	severus
suiviez	follow
entraînement	training
intensif	intensive
punir	punish
ajouta-t-elle	"she added,
excellent	excellent
plaisantes	pleasant
jouent	play
oublia	forgot
l'entraînement	training
tient	holds
batteurs	drummers
gagne	wins
gagné	won
formidable	great
gregory	gregory
repéré	spotted
partis	parties
retournes	return
faisais	did
copains	buddies
qualificatif	qualifier
froncer	pucker
vexé	vexed
second	second
évalua	assessment
retrouve	found
trophées	trophies
tournèrent	turned
entends	hear
dégagé	loose
meurt	dies
duels	duels
arriverez	arrive
envoyer	send
étincelles	sparks
connaissez	know
refuses	refuse
j'agiterai	I agiterai
jette-la	throws-the
paix	peace
s'adressa	addressed
disiez	tell
promeniez	stroll
ferez	will
forcément	necessarily
égoïste	selfish
promettait	promised
repos	rest
arrange-toi	arrange yourself
esquiver	dodge
neutraliser	neutralize
risques	risks
fassent	do
tentait	tried
descendirent	went down
braises	embers
rougeoyaient	rougeoyaient
créatures	creatures
informes	shapeless
tapies	tapies
atteint	reached
puisses	can
tremblota	tremblota
froncés	a frown
obstination	obstinacy
d'autrui	of others
pivoter	rotate
émettant	emitting
sifflements	whistling
fichez	do not care
pensez	think
vous-mêmes	you own
fassiez	do
gagnés	earned
renvoyés	returned
souviendrez	remember
surent	knew
toile	canvas
rattrapés	caught up
dirai	tell
pourrez	can
témoigner	witness
faveur	for
manques	gaps
culot	socket
reniflait	sniffed
scrutant	peering
n'arrivais	couldn
groin	snout
arrangé	arranged
jure	swear
j'apprendrai	I will learn
remettrez	forgive
taire	shut up
zébrés	zebra
rayons	ray
lune	moon
projetaient	projected
parvinrent	managed
encombre	clutters
vitrines	showcases
coupes	cuts
écus	ecu
plateaux	trays
statuettes	statuettes
l'attaquer	the attack
attendirent	waited for
dégonflé	deflated
brandit	holds up
cherche	looking
désespérés	desperate
s'enfuient	flee
filèrent	spinning
franchir	cross
entendaient	heard
apeuré	frightened
rattraper	catch up
armure	armor
s'ensuivit	followed
parvenus	managed
foncèrent	foncèrent
dédale	maze
tapisserie	tapestry
s'engouffrèrent	if engouffrèrent
ralentir	slow down
l'allure	the look
semé	sown
d'haleine	breath
plié	folded
bruits	noise
tendu	tense
piège	trap
intention	intention
reconnaître	recognize
jaillir	squirt
ravie	happy
promène	walks
devrais	should
déclara-t-il	he said
vertueuse	virtuous
malice	malice
fiche	sheet
laisse-nous	let us
écarter	aside
eleves	students
coururent	ran
fichus	damn
vainement	in vain
provenaient	came
alohomora	alohomora
déclic	click
l'ouverture	the opening
refermèrent	slid shut
collèrent	collèrent
sont-ils	are they
allés	went
dira	tell
chantonna	crooned
exaspérant	infuriating
queloue	queloue
rafale	burst
insistait	insisted
cauchemar	nightmare
c'en	it
comprenaient	included
monstrueux	monstrous
remplissait	filled
paires	pairs
démente	insane
museaux	snouts
flairaient	flairaient
frémissant	quivering
avidité	greed
gueules	gules
bavantes	bavantes
hérissées	bristling
crocs	crocs
jaunâtres	yellowish
filets	nets
épais	thick
cordes	strings
dévorés	devoured
grognements	grunts
roulaient	rolled
tâtons	groping
choisissait	chose
reculons	backwards
claquèrent	slammed
ailleurs	elsewhere
l'aperçurent	the saw
maximum	maximum
importance	importance
pantelant	breathless
laissèrent	left
membres	members
prend	takes
d'exercice	exercise
pattes	legs
trappe	hatch
évident	obvious
flamboyant	flamboyant
contents	happy
dérange	mind
obligée	forced
objet	object
découvert	discovered
crut	believed
joyeuse	joyful
aventure	adventure
révélé	revealed
l'existence	the existence
transféré	transferred
justifier	justify
protection	protection
dissuasive	deterrent
valeur	value
soixantaine	sixty
indice	index
avantageux	advantageous
souhaitaient	wanted
venger	revenge
donnée	given
distribution	distribution
envahirent	invaded
l'attention	attention
attirée	drawn
envoyant	sending
n'ouvrez	do not open
sache	know
voudront	want to
attend	waiting
séance	session
éprouvant	experiencing
difficultés	difficulties
barrèrent	barrèrent
tâtant	feeling
mêlée	melee
d'envie	envy
fichu	damn
marque	brand
comète	comet
évidemment	of course
achetez	buy
brindille	twig
couina	couina
gratifiant	rewarding
s'agit-il	is it
horrifiée	horrified
dissimuler	hide
récompense	reward
violé	violated
courroucée	wrathful
montait	rose
désapprobateur	désapprobateur
croyais	thought
parlais	was talking about
rangé	tidy
jouer	play
admiration	admiration
superbe	superb
élégante	elegant
faisceau	beam
brindilles	twigs
droites	straight
lisses	smooth
gravée	engraved
crépuscule	twilight
entrait	entered
stade	stage
gradins	bleachers
installés	installed
permettaient	allowed
spectateurs	spectators
placés	placed
spectacle	show
plantés	planted
poteaux	posts
surmontés	overcome
cercles	circles
verticaux	vertical
ressemblaient	looked like
bâtonnets	sticks
soufflent	blow
bulles	bubbles
poteaux-là	posts-there
impatient	looking forward
l'enfourcha	the enfourcha
enchaînait	her
caresse	caress
chandelle	candle
fonçait	hurtled
atterrit	lands
t'apprendre	you learn
participeras	take part in
entraînements	workouts
simples	simple
comporte	features
poursuiveurs	poursuiveurs
souafle	souafle
passent	pass
essayent	try
marquer	mark
rapporte	reports
poursuiveur	poursuiveur
lance	lance
basket-ball	basketball
paniers	baskets
importe	any
continue	continues
appelle	calls
consiste	is
adverse	opposing
servent	serve
batte	bat
battes	bats
base-ball	baseball
t'expliquer	explain
cognards	cognards
lanières	strips
maintenaient	maintained
boue	mud
recule	retreats
libéra	freed
l'envoya	sent
zigzaguer	weaving in and out of
charge	load
s'attaqua	if attacked
plongea	dove
i'immobiliser	I stop
forçant	forcing
cognard	cognard
nôtre	ours
occupent	occupy
attaques	attacks
buts	goals
protège	protects
tiennent	take
récita	recited
d'adopter	to adopt
passons	pass
membre	member
l'attrapeur	the monkey net
n'auras	there will
soucier	worry about
fracassent	crushing
crâne	skull
eux-	them-
humains	human
comparée	compared
pourvue	with
ailes	wings
rapidité	speed
saisir	enter
faufiler	sneak
parvient	manages
assure	ensures
victoire	victory
termine	ends
indéfiniment	indefinitely
record	record
remplaçants	replacements
utilisera	use
ordinaires	common
rata	rata
durent	last
deviennes	to become
d'angleterre	of england
intéressants	interesting
maintenait	maintained
assimilé	assimilated
notions	concepts
élémentaires	elementary
réveillèrent	woke
délicieuse	delicious
citrouille	pumpkin
rêvait	dreamed
plané	glide
partenaire	partner
fâché	angry
n'oubliez	do not forget
levez	lift
tournez	turn
rappelez-vous	remember
prononcez	say
formule	formula
baruffio	baruffio
défaut	default
prononciation	pronunciation
retrouvée	found
bison	bison
vison	mink
l'éteindre	turn it off
wingardium	wingardium
leviosa	leviosa
s'écriait-il	called it
agitant	waving
moulin	mill
prononces	praying
win-gar-dium	win-gar-dium
accentuant	accentuating
manches	short
articula	articula
leiviosa	leiviosa
applaudissant	applauding
comble	fills
l'exaspération	the exasperation
m'étonne	amazes me
fille-là	girl
dépassa	exceeded
bousculant	hustling
rendant	making
copine	girlfriend
aise	comfortable
dérangée	disturbed
spécialement	specially
décorée	decorated
pleurs	crying
chauves-souris	bats
voletaient	voletaient
fondaient	based
nuages	clouds
vaciller	waver
citrouilles	pumpkins
évidées	hollowed-out
mets	mets
festin	feast
déformé	distorted
précipiter	rush
balbutier	stammer
évanoui	fainted
tumulte	tumult
gerbes	sheaves
rétablir	restore
messieurs	gentlemen
condisciples	classmates
respectives	respective
restez	stay
groupés	grouped
n'aurez	will not
m'obéissez	me obey
écartez-vous	out, you
figurez-vous	imagine you
frayèrent	advanced
refluaient	ebbed
désordre	disorder
lèvre	lip
partaient	went
latéral	side
précipités	precipitates
griffon	griffon
jetèrent	cast
aperçurent	saw
descendu	down
profs	teachers
faufilèrent	faufilèrent
nauséabonde	foul
chaussette	sock
entretenues	maintained cross-country trails
géants	giants
masse	mass
recroquevillèrent	recroquevillèrent
terne	dull
verrues	warts
plantée	planted
courtes	short
épaisses	thick
troncs	trunks
d'arbre	tree
hérissés	spiky
pointes	tips
défiait	challenged
gigantesque	gigantic
massue	club
traînait	dragged
baissa	lowered
s'engouffra	rushed
l'enfermer	the lock
priant	praying
n'ait	did
verrouiller	lock
déchirant	ripping
désespéré	desperate
s'exclamèrent-ils	saying they
rouvrir	reopen
plaquée	plated
lavabos	sinks
l'attirer	the draw
robinet	faucet
lent	slow
hésita	hesitated
soulevant	lifting
glissé	slipped
tuyau	hose
mufle	muzzle
repoussant	pushing
collée	stuck
figée	frozen
répercutés	passed
écho	echo
issue	after
empoignant	clutching
élan	momentum
s'accrocher	hang on
narine	nostril
trémoussa	trémoussa
abattre	shoot down
effondrée	collapsed
évanouie	fainted
hasard	random
prononça	spoke
apprise	learned
vacilla	wavered
entraîné	led
flageolantes	flageolantes
inanimée	inanimate
récupéra	retrieved
restée	remained
enfoncée	key
couverte	covered
colle	glue
grumeaux	lumps
beuââârk	beuââârk
morve	snot
essuya	wiped
rugissements	roars
inaperçus	unnoticed
irruption	burst
fermait	closed
gémissement	moaning
livides	livid
froide	cold
échangea	exchanged
n'êtes-vous	are you
relever	meet
occuper	care
moi-	me-
trolls	trolls
lâcha	released
mentir	lie
m'avaient	I had
morte	dead
enfoncé	pressed
l'assommer	the knock out
sotte	silly
enfreint	violated
distribuer	distribute
conduite	conduct
décevez	disappoint
blessée	injured
terminent	end
combattre	fight
adulte	adult
informé	informed
dépêchèrent	dispatched
enlevé	removed
qu'a	that has
d'affaire	business
sauvé	saved
rappela	reminded
dirent-ils	they said
bondée	crowded
crée	creates
liens	links
particuliers	individuals
novembre	November
d'acier	steel
givre	frost
emmitouflé	bundled up
dégivrait	dégivrait
gagnait	won
prendrait	would
championnat	championship
s'entraîner	train
l'arme	the weapon
fuites	leaks
jouerait	play
d'attrapeur	of monkey net
affirmaient	said
promettaient	promised
matelas	mattress
amortir	cushion
l'amitié	the friendship
aidé	helped
compenser	offset
prêté	lent
lecture	reading
instructive	informative
fautes	mistakes
commises	committed
1473	1473
attrapeurs	rat catchers
rapides	fast
accidents	accidents
graves	serious
arbitres	referees
réapparaître	reappear
désert	desert
sahara	sahara
qu'enfin	finally
mourait	died
rarement	rarely
sauvée	saved
retrouvés	found
récréation	recreation
fabriquer	make
bocal	jar
réchauffaient	warmed
flamme	flame
bleue	blue
confisque	impounds
traverser	cross
boitait	lame
décela	décela
vague	wave
culpabilité	guilt
d'emporter	take
donnez-le-moi	give it to me
j'enlève	I take off
d'inventer	to invent
s'éloignait	depart
claudiquant	who is limping
amer	bitter
soir-là	evening
vérifiait	checked
laissés	left
copier	copy
feriez-vous	would you
réponses	answers
l'aiderait	help
détendre	relax
devrait-il	should it
répondirent	answered
présents	present
requête	query
entrouvrit	entrouvrit
relevé	statement
sanglante	bloody
pansements	dressings
bestiole	critter
voulez-vous	do you want to
surveille	monitors
balbutia-t-il	stammered out there
immÉdiatement	immediately
d'enlever	to remove
rejoint	joined
t'arrive	you can
comprenez	understand
conclut-il	he concludes
parier	bet
diversion	diversion
n'essaierait	do not try
saints	saints
frite	fried
retentissait	there was a tremendous burst
joyeuses	happy
manges	eat
l'encouragea	he encouraged
l'approche	the approach
nouait	protocol generally took shape
prennes	take
cible	target
principale	main
rassemblée	collected
déployé	deployed
bannière	banner
président	president
dessiné	designed
vestiaires	locker rooms
revêtaient	were
habillés	dressed
mesdemoiselles	ladies
angelina	angelina
johnson	johnson
jouait	played
corrigea	corrected
attendions	expected
discours	speech
d'olivier	olivier
coupa	cut
ayons	have
accueillis	welcome
chargée	responsible
d'arbitrer	to arbitrate
placée	placed
fair-play	fair play
prévint-elle	warned-it
marcus	marcus
flint	flint
l'œil	the eye
l'inscription	the registration
enseigne	teaches
néon	neon
brève	brief
redonna	gave
s'empare	grabs
commentateur	commentator
commentaire	comment
surveillait	watching
alicia	alicia
spinnet	spinnet
suppléante	alternate
reprend	resumes
vole	flies
adverses	adverse
arrêté	stopped
katie	katie
bell	bell
joli	nice
plongeon	dip
adrian	adrian
pucey	pucey
précipite	rush
batteur	drummer
évite	avoids
bletchey	bletchey
plonge	plunges
supporters	supporters
saluèrent	greeted
l'exploit	the feat
partisans	supporters
répandaient	spread
lamentations	lamentations
poussez-vous	push-you
serrèrent	shook
regardais	watched
accrochées	hung
califourchon	astride
marqué	marked
loopings	loop
d'intervenir	to intervene
éclat	glow
brilla	shone
foncer	create
poursuiveuse	poursuiveuse
fonce	dark
parcourut	went through
qu'adrian	adrian
perdait	lost
l'éclat	the glow
terence	terence
higgs	higgs
désintéressés	the disinterested
bloquer	block
dévié	deviated
trajectoire	path
cramponné	clamped
hurlèrent	screamed
l'ordre	the order
franc	frank
renvoyez-le	return the
approuvait	approved
scandaleuse	scandalous
tricherie	cheating
révoltante	the revolting
bénéficie	benefits
penalty	penalty
embardée	swerve
fraction	fraction
rodéo	rodeo
désarçonner	dismounting
virer	turn
zigzaguait	zigzagged
multipliant	multiplying
embardées	lurching
commenter	comment
frappée	hit
plaisantais	was joking
poussèrent	pushed
l'altitude	the altitude
soubresauts	blips
fabrique	manufactures
l'observait	the observed
contrôle	control
m'étonnerait	I doubt
pointèrent	pointed out
cramponner	cling
désarçonnant	disarms
bloqué	blocked
dérégler	dysregulate
n'arriverait	does not happen
diriger	direct
s'empara	seized
fixait	set
remuaient	remuaient
récité	recited
formules	formulas
vibrait	vibrated
horrifiés	horrified
levés	surveys
d'attraper	to catch
inutiles	useless
approchaient	approaching
d'altitude	altitude
au-dessous	below
emparé	seized
l'indifférence	the indifference
frayé	spawned
sienne	siena
bouscula	pushed
s'excuser	apologize
s'accroupit	squats
bleues	blue
prouva	proved
détourner	divert
là-haut	up there
rétablissement	recovery
redescendit	down
brutalement	brutally
toussa	coughed
doré	golden
totale	total
l'avaler	the swallow
l'interdisait	the prohibited
remporté	won
soixante-dix	seventy
soixante	sixty
n'entendit	heard
affirma	said
pouvaient	could
annonça-t-il	he announced
mordre	bite
touffu	bushy
grec	Greek
posez	ask
là-dessus	it
fixer	fix
l'objet	the object
visés	referred to
cillé	notice
s'emporta	if carried
comporté	featured
écoutez-moi	listen to me
regardent	watch
oubliez	forget
miroir	mirror
riséd	riséd
mi-décembre	in mid-December
gelé	frozen
reçurent	received
fabriqué	manufactured
visant	aimed
s'occupait	was
arrivaient	arrived
frigorifiés	refrigerated
chauffaient	heated
parcourus	driven
courants	common
glacés	icy
serraient	shake
plains	plains
malheureux	unhappy
pouffèrent	pouffèrent
prêta	lent
défaite	defeat
rieurs	laughing
répétant	repeating
remplacer	replace
crocodile	crocodile
bâiller	yawn
n'amusait	not amused
impressionné	impressed
virtuosité	virtuosity
jaloux	jealous
consolait	consoled
occasions	opportunities
n'irait	there would be a
classes	classes
resteraient	would
s'inscrire	register
passeraient	would
sapin	fir
haletant	panting
ahanant	labouring
dépasser	exceed
trahissaient	betrayed
d'aide	help
passant	from
branchages	branches
essayes	try
vises	referred to
palace	palace
provoqué	caused
insulté	insulted
doucereux	sugary
estimez-vous	do you feel you
filez	filez
avancèrent	forth
l'aurai	the will
deux-là	two
gaieté	gaiety
merveille	wonder
s'affairaient	busy
installer	install
décorations	decorations
mettez-le	put the
guirlandes	garlands
d'arbres	trees
dressaient	up
glaçons	ice cubes
scintillants	sparkling
allumées	lit
s'arrachant	tearing
accrochait	hung
branches	branches
interloqué	nonplussed
ecoutez-moi	listen to me
vouliez	want to
vous-même	you
épargner	save
consulté	consulted
cherchera	will
mécontent	unhappy
disposaient	had
dizaines	tens
d'ouvrages	books
consultés	consulted
ignoraient	did not know
figurer	be
contemporain	contemporary
découvertes	discoveries
etude	study
récents	recent
progrès	progress
feuilleter	browse
volumes	volumes
renoncé	waived
étudia	studied
titres	securities
thèmes	themes
promenait	walking
aventuré	ventured
réserve	reserve
accès	access
conservait	retained
n'obtiendrait	would
autorisation	authorization
traitaient	treated
poussées	flare-ups
consulter	consult
cherches	are looking for
pince	clamp
bibliothécaire	librarian
plumeau	feather duster
n'ayant	having
plausible	plausible
résigna	resigned
renseignements	information
trouvent	find
duré	lasted
consacrer	devote
surprenant	surprising
continuellement	continually
continuerez	continue
envoyez-moi	send me
savent	know
dentistes	dentists
commencèrent	started
d'occasions	opportunities
rassemblait	together
broche	pin
pain	bread
pancakes	pancakes
marshmallows	marshmallows
échafaudant	échafaudant
stratégies	strategies
plans	plans
irréalisables	impossible
apprit	learned
d'échecs	chess
version	version
vivantes	living
armée	army
partant	hence
l'échiquier	the chessboard
abîmé	damaged
grand-père	grand-father
l'occurrence	the occurrence
fréquentait	consorted
prêtées	lent
contestaient	challenged
décisions	decisions
jetait	cast
m'envoie	sends me
cavalier	jumper
coucha	lay down
réveillon	new year's eve
s'éveilla	woke
s'extrayait	is extracted
flûte	flute
fabriquée	manufactured
souffla	blew
ululement	ululement
pence	pence
adhésif	adhesive
gentil	nice
fasciné	fascinated
prends-la	take the
rougissant	blushing
pull-over	pull-over
laine	wool
tricoté	knitted
faits	facts
tricote	knits
déballant	unpacking
mien	mine
goûtant	tasting
fondant	based
révéla	revealed
tissu	fabric
teinte	hue
forma	forma
existe	there is
précieux	precious
transformée	transformed
étoffe	fabric
d'invisibilité	invisibility
essaye-la	try-the
invisible	invisible
s'effaça	vanished
enleva	removed
écriture	writing
arrondie	rounded
hérites	hérites
fais-en	make
signature	signature
admiratif	admiring
d'efforts	efforts
n'as-tu	have you
mets-le	put the
mettant	putting
n'oublies	do not forget
gred	gred
forge	forge
réprobateur	réprobateur
je-ne-veux-pas-le	I-don't-want-not-the
l'obligeaient	the forced
enfiler	thread
traînèrent	dragged
immobilisés	fixed
dindes	turkeys
rôties	roasted
d'airelles	blueberry
pochettes-surprises	pockets-surprises
pétards	firecrackers
crépon	crépon
partagea	shared
explosa	exploded
enveloppant	wrapping
contre-amiral	rear-admiral
bûches	logs
pudding	pudding
dent	tooth
trouvant	finding
mornille	mornille
troqué	swapped
bonnet	bonnet
fleurs	flowers
pochette-	cover-
écoutant	listening to
réclama	asked
contentement	contentment
encombrés	congested
découverts	discovered
ballons	balloons
lumineux	bright
increvables	puncture-proof
batailles	battles
mouillés	wet
essoufflés	out of breath
étrenna	étrenna
plate	flat
couture	couture
acharné	hard
dinde	turkey
pains	bread
gâteaux	cakes
somnolents	sleepy
expéditeur	sender
rôtie	roasted
préoccupation	concern
cachée	hidden
légère	light
l'étoffe	the fabric
coulait	flowed
ruisseau	creek
était-il	was it
l'essayer	try it
s'enveloppa	wrapped herself
ombres	shadows
réveillé	woke up
fallait-il	was it
dissimulait	hid
plongée	diving
atmosphère	atmosphere
effrayante	scary
enjamba	stepped over
cordon	cord
interdits	banned
dorées	golden
ternies	tarnished
usées	waste
formaient	formed
titre	title
maculé	dirty
dresser	draw
jouait-elle	played it
chuchotement	whisper
provenait	came
rangées	rows
posant	posing
s'intéressa	if interested
l'étagère	the shelf
volume	volume
équilibre	balance
suraigu	hyperacute
glacer	icing
assourdissante	deafening
instantanément	instantly
saisi	seized
résonnaient	resounded
résonnait	sounded
rôder	prowl
raccourci	shortcut
grasseyante	grasseyante
s'avançaient	advanced
inévitablement	inevitably
heurter	face
supprimait	removed
entrouverte	ajar
retenant	retaining
l'insu	the blind
s'adossa	if adossa
chaud	hot
jette	throws
désaffectée	disused
pupitres	keyboards
entasses	entasses
papiers	papers
retournée	returned
appuyé	supported
appartenir	belong
mobilier	furniture
ranger	ranger
cadre	framework
sculpté	carved
pourvus	filled
griffes	claws
d'animal	animal
déchiffra	deciphered
elrue	elrue
ocnot	ocnot
edsi	edsi
amega	amega
notsap	notsap
nomen	nomen
calmée	calmed down
vérifier	check
plaquer	tackle
étouffer	choke
apparu	appeared
personnes	people
invisibles	invisible
faculté	faculty
refléter	reflect
n'existaient	there were
auburn	auburn
miens	mine
coiffés	styled
épis	ears
dépassaient	exceeded
touchait	touched
détailla	detailed
verts	green
siens	his
souriaient	smiling at her
adressaient	directed
s'effaçaient	deferred
lassait	tired
ramène	back
complet	complete
dommage	damage
enveloppés	wrapped
essayèrent	tried
refaire	redo
fuyant	fleeing
errèrent	wandered
gèle	freezes
laissons	let
débarrassa	rid
rayonner	shine
mets-toi	put yourself
plaça	plaça
regarde-moi	look at me
arrête	stop
provenance	from
apparaissaient	appeared
ayant	having
méfions-nous	let us beware
entendus	heard
penses	think
risqué	risky
n'arrêtent	do not stop
risquez	may
finiras	will
s'apercevront	will find
rencontres	meetings
grands-pères	grandfathers
hochait	swung
l'invisibilité	the invisibility
myope	short-sighted
l'appelait	the called
savez-vous	do you know
t'aide	to help you
profond	deep
connu	known
ronald	ronald
d'honneurs	honors
hommes	men
dépéri	wasted away
devenus	become
réel	real
averti	warned
rêves	dreams
oubliant	forgetting
remets	put
recommencer	again
s'obstinent	sticks
m'offrir	offer me
personnelle	personal
cauchemars	nightmares
disparaissaient	disappeared
aigrelet	sour
reprise	recovery
différemment	differently
partagée	shared
l'horreur	the horror
t'avait	you had
déception	disappointment
trimestre	quarter
recommencèrent	started
récréations	recess
incessante	incessant
modérer	moderate
ardeurs	enthusiasm
opposerait	would
épuisé	exhausted
s'entraînaient	trained
boueux	muddy
fâcha	angry
cessaient	stopped
arrêtez	stop
arbitrer	arbitrate
prétextes	excuses
entendant	hearing
devancer	ahead of
défavoriser	the disadvantage of
défendit	defended
pouvons	can
impeccablement	impeccably
personnelles	personal
souhaiter	wish
rentra	returned
jouaient	played
échecs	chess
concen	concen
t'être	you be
casse-toi	fuck off you
remplaçant	replacing
déclare	said
forfait	package
collées	pasted
connue	known
maléfice	hex
bloque-jambes	blocks-legs
sautillant	hopping
joints	joints
annulant	cancelling
effets	effects
détachèrent	untied
chevrotante	chevrotante
croisé	cross
conseilla	advised
raconte-lui	tell him
rapporterait	would
d'ennuis	trouble
défendes	défendes
faciliter	facilitate
couchant	sunset
offerte	available
vaux	vaux
est-il	is it
choco	choco
dévorant	devouring
l'avais	had
amenés	brought
ecoutez	listen
attendez-moi	wait for me
chargés	loaded
fébrilité	excitement
parles	talk
gestes	gestures
frénétiques	frantic
alchimiste	alchemist
philosophale	philosopher's
lisez	read
anciennes	old
alchimiques	alchemical
substance	substance
légendaire	legendary
dotée	with
étonnants	amazing
propriété	property
métal	metal
l'élixir	the elixir
immortel	immortal
boit	drunk
siècles	centuries
l'œuvre	the work
amateur	amateur
d'opéra	opera
célébré	celebrated
soixante-	sixty-
mène	leads
paisible	peaceful
devon	devon
pernelle	pernelle
cinquante-huit	fifty-eight
l'or	gold
essaie	try
jeunesse	youth
copiant	copying
morsures	bites
loup-garou	loup-garou
achèterait	buy
jouerai	play
défile	scrolls
d'affronter	face
sereins	serene
enthousiasmait	excited
pourraient-ils	could they
arbitre	referee
partial	partial
suivait	followed
surprendre	surprise
odieux	heinous
hebdomadaire	weekly
savait-il	did he know
l'abominable	the abominable
souhaitèrent	wanted
demandaient	asked
reverraient	would revisit
réconfortante	comforting
d'encouragement	encouragement
préparaient	prepared
d'apporter	to make
entraînés	trained
emprunté	borrowed
comptaient	had
manifestait	manifested
n'oublie	do not forget
locomotor	locomotor
mortis	mortis
m'agacer	annoy me
pression	pressure
favoriser	foster
assister	attend
périlleux	perilous
précipitant	precipitating
n'oserait	no one would dare to
d'accorder	grant
croisés	crusaders
tournoyait	billowed
choisissent	choose
accordait	granted
injustifié	unjustified
pitié	pity
cerveau	brain
tonitruant	thundering
nerfs	nerves
amorcé	started
spectaculaire	spectacular
exclamations	exclamations
angoissées	anxious
d'enthousiasme	enthusiasm
ressort	spring
immobilisé	locked
banc	bench
main-forte	hand-in-hand
sautant	jumping
roulé	rolled
prises	taken
tourbillon	whirlpool
écart	gap
n'évita	not avoided
effectuait	was
triomphe	triumph
es-tu	are you
dansant	dancing
envahissaient	invaded
serrées	tight
joué	played
cracha	spat
hangar	hangar
accompli	accomplished
revit	revit
images	images
accouraient	came
ensanglanté	bloody
flamboyer	blaze
exploit	feat
affronté	faced
encapuchonnée	hooded
descendre	down
qu'allait-il	what was it
dînait	was having dinner
touffus	thick
s'orienta	turned
s'accrocha	clung to
feuillage	foliage
clairière	glade
distinguer	distinguish
bégaiement	stuttering
empiré	worse
confidentielle	confidential
censés	supposed to
marmonnait	muttered
dévorer	devour
voudriez	would like to
ennemi	enemy
rattrapa	caught
phrase	sentence
suivante	following
j'attends	I'm waiting for
aurons	will
étais-tu	were you
exulta	exulted since
tapes	tapes
beurre	butter
t'attend	waiting for you
précipité	precipitated
rendirent	made
fermèrent	closed
deviné	guessed
obliger	require
l'auraient	would
cédé	sold
collaient	stuck
manquait	missing
occasion	opportunity
habituelle	usual
établir	establish
révisions	revisions
examens	reviews
harcelait	harassing
éternité	eternity
correspond	is
réviser	review
malheureusement	unfortunately
imposé	imposed
pâques	easter
songer	consider
réciter	recite
usages	uses
exercices	exercises
bâillant	yawning
maugréant	grumbling
n'arriverai	do not get
myosotis	forget-me-not
l'atmosphère	the atmosphere
parfum	perfume
consacré	dedicated
dictame	dittany
s'écrier	exclaim
taupe	taupe
déplacé	moved
naturelle	natural
soupçonneux	suspicious
intéresser	interest
cherchions	looking for
savons	know
philo	philo
écoutait	listened to
voulions	wanted
prévu	expected
promets	promise
jacasser	babble
parquet	parquet
songeur	pensive
section	section
bouquins	books
consacrés	dedicated
d'irlande	ireland
l'œuf	the egg
brasier	blaze
guide	guide
l'amateur	the amateur
lois	laws
l'élevage	livestock
convention	convention
1709	1709
veux-tu	do you want to
impossibles	impossible
voyais	saw
brûlures	burns
sauvages	wild
grande-bretagne	great britain
gallois	welsh
hébrides	hebrides
étouffante	stifling
qu'au-dehors	that outside
clémente	clement
prépara	prepared
l'hermine	the ermine
refusèrent	refused
l'ignore	ignore
dirais	would say
l'aviez	had
flatteur	flattering
dispositif	device
demandions	ask
évoquer	discuss
bomba	bomba
torse	torso
doutiez	thinking about it
participé	participated
assurer	ensure
ignorer	ignore
moyen	average
l'avez	have
s'accroupissant	squatting
examiner	review
éclos	hatched
retirant	removing
oreiller	pillow
l'elevage	livestock
l'agrément	the accreditation
commerce	trade
daté	dated
nature	nature
mélangé	mixed
demi-heures	half-hours
expliquent	explain
norvégien	Norwegian
crête	crest
fit-elle	"she
n'écoutait	not listened to
chantonnant	humming
d'inquiétude	anxiety
qu'arriverait-il	what would happen
s'apercevait	notices
abritait	housed
signé	signed
d'éclore	to hatch
dissuada	dissuaded him
qu'aura	that will
finira	will
qu'avait-il	what had he
n'aimait	never liked
finirent	finally
cloche	bell
accueillit	welcomed
excité	excited
profondes	deep
crevasses	crevices
coquille	shell
s'assirent	sat
observèrent	watched
pataude	pataude
fripé	crumpled
énormes	huge
comparées	compared
grêle	hail
museau	muzzle
naissantes	emerging
éternua	sneezed
jaillirent	out
caresser	caress
pointus	sharp
brave	brave
reconnu	recognized
atteigne	reaches
enfui	away
tromper	fool
dessinait	drew
raisonner	reason
relâchez-le	release
mourrait	would die
contemplèrent	gazed at
triplé	tripled
naseaux	nostrils
négligeait	neglected
jonché	littered
embués	steamy
quinzaine	fifteen
l'abandonner	abandon
perds	lose
étudie	studies
s'occupera	will
relâchera	release
envoient	send
pendule	pendulum
accrochée	hung
sonner	ring
recouvrait	covered
kilos	pounds
mordu	bitten
enveloppée	wrapped
chantait	sang
berceuse	lullaby
lurent	read
vas-tu	are you going to
m'occuper	take care
pourriez-vous	could you
retrouveront	find
profiteront	the benefit of
bises	kisses
approuvèrent	approved
l'essentiel	the essential
ennui	boredom
mordue	bitten
doublé	doubled
hésitait	hesitated
allait-elle	would she
morsure	bite
venimeux	venomous
piteux	sorry
m'emprunter	me borrow
moquer	fun
menacé	threatened
calmer	calm down
promit	promised
apaisé	appeased
n'eurent	had
d'ajouter	add
d'envoyer	send
pansement	dressing
souffla-t-il	"he muttered
rassurez-vous	don't worry
annoncèrent	announced
remplirent	filled
botte	boot
séparer	separate
enfermé	locked
ours	bear
peluche	plush
sente	feel
l'ours	the bear
recouvraient	covered
t'oubliera	you will forget
fardeau	burden
manqua	missed
rencognèrent	rencognèrent
silhouettes	silhouettes
débattre	discuss
s'alluma	lit
écossaise	scottish
filet	net
retenue	withholding
s'écria-t-elle	cried she
osez-vous	dare you
pouvez-vous	can you
proférer	utter
mensonges	lies
balcon	balcony
ôtèrent	stripped
esquissa	lips
danse	dance
vaudrait	would
contentèrent	content
pouffer	pouffer
s'agitait	stirred
surgirent	arose
harnais	harness
attacher	attach
poignées	handles
remerciant	thanking
chaleureusement	warmly
libres	free
redescendirent	climbed back down
débarrassés	rid
récolté	harvested
tremblait	shaking
convaincante	convincing
avaient-ils	had they
excuse	excuse
promènent	walk
d'astronomie	astronomy
ajoutait	added
réapparut	reappeared
cherché	sought
coincer	stuck
drag	drag
frénétique	frantic
interrompre	interrupt
cracher	spit
chaussons	slippers
nécessaire	necessary
peinée	pained
outrée	outraged
attachiez	buckling
prestige	prestige
croyez-moi	believe me
autorise	authorizes
errer	wander
période	period
extrêmement	extremely
suffoqué	muffled
perdaient	lost
gagnée	won
retournez	return
honte	shame
relégué	relegated
remporter	win
handicap	disability
dormit	slept
sangloter	sob
consoler	comfort
l'aube	dawn
apprendraient	learn
sabliers	hourglasses
comptabilisaient	tracked
crurent	believed
auraient-ils	would they
populaire	popular
admiré	admired
prenaient	took
espéré	hoped
perdraient	lose
apparaissait	appeared
l'insultait	the insulted
applaudissaient	clapping
l'acclamaient	cheered
fidèle	faithful
auront	will
assura-t-il	assured-t-he
quantités	quantities
aime	love
réparer	repair
dégâts	damage
jura	jura
démissionner	resign
regagner	return
d'adresser	address
désignaient	have used
souffraient	suffered
d'avanies	of affronts
connus	known
gardant	keeping
baissée	down
travaillant	working
approche	approach
occupaient	occupied
malheurs	woes
promesse	promise
l'épreuve	the test
recommencez	repeat
implorait-il	had to beg for it
menaçait	threatened
redressant	straightening
souvenant	remembering
philosophales	philosophales
menaces	threats
bouquin	book
indique	indicates
l'aventure	the adventure
tente	tent
nous-mêmes	ourselves
preuve	proof
confirmer	confirm
contentera	only
prétendre	claim
ignore	ignore
entré	entered
pensera	think
inventé	invented
aiderait	help
dépendait	depended on
convaincue	convinced
contentait	just
fouiner	snoop
proposa-t-il	he proposed to institute
fouiné	nosed
jupiter	jupiter
satellites	satellites
retenues	deductions
signifiées	served
officiellement	officially
distribua	distributed
commencera	begin
l'agitation	the hustle and bustle
provoquée	caused
plaigne	complain
perdue	lost
estimait	estimated
méritaient	deserved
conduisant	leading
repenserez	repenserez
violer	violate
règlements	regulations
souffrir	suffer
apprend	learn
punitions	punishment
n'aient	have
temps-là	time
suspendait	suspended
poignets	cuffs
chaînes	channels
entretiens	interviews
servirait	would
consister	consist of
redoutable	formidable
réjoui	pleased
masquaient	masked
plongeaient	dove
décevoir	disappoint
imaginez	imagine
fainéant	lazy
détrompez-vous	think again-you
entiers	whole
ressortirez	come up
morgue	morgue
bestioles	critters
loups-garous	werewolves
surgit	arises
carquois	quiver
flèches	arrows
bandoulière	shoulder strap
punis	punished
attributions	assignments
restera	will
trahissait	betrayed
domestiques	domestic
lignes	lines
goût-là	taste-there
apprenait	learned
d'utile	useful
ailles	go
amena	brought
lisière	edge
sentier	trail
contemplaient	contemplated
brille	shines
malheureuse	unfortunate
je-ne-sais-quoi	I-don't-know-what
altérait	alter
écartez	spread
groupes	groups
traces	traces
directions	directions
trouillard	scaredy-cat
vertes	green
entraînez-vous	train
rouges	red
bifurcation	bifurcation
rivés	riveted
feuillages	foliage
briller	shine
argenté	silver
feuilles	leaves
mortes	dead
faciles	easy
puissants	powerful
blesser	hurt
souche	strain
mousse	foam
cachez-vous	hide
derriÈre	behind
flèche	arrow
l'ajusta	the adjusted
tendirent	craned
rampait	was crawling
scruta	watched
risqua	risked
sombrement	darkly
guettant	watching
montrez-vous	show you
noisette	hazel
rougeâtres	reddish
ronan	ronan
centaure	centaur
t'apprêtais	you came
dégât	damage
bonsoir	hello
apprenez	learn
mars	march
remarqua-t-il	he noted
tombés	fallen
innocents	innocent
premières	first
d'inhabituel	unusual
bane	bane
écoutez	listen
dites-le-moi	tell me
centaures	centaurs
d'obtenir	to obtain
claire	clear
intéresse	interested
l'ennui	boredom
bavards	talkative
sabots	hooves
l'épaisse	the thick
éloignez	away
viendrai	come
rechercher	search
s'enfoncer	sink
sous-bois	sous-bois
échangeant	exchanging
blessés	injured
m'est	I
égal	equal
interminables	endless
ouïe	hearing
s'affinait	if affinait
percevait	perceived
passait-il	was it
fulminait	was in the midst
comprirent	understood
approché	approached
raffut	fuss
restes	remains
n'arrivera	not going to happen
partit	left
marchèrent	marched
avançaient	advanced
impraticable	impractical
abondantes	abundant
débattue	discussed
minces	thin
repliées	folded
formait	formed
perle	pearl
lorsqu'un	when a
buisson	bush
rampa	rampa
traquant	tracking
gibier	game
pétrifiés	petrified
cadavre	corpse
flanc	flank
déchire	tears
aaaaaaaaaaaaaaaaargh	aaaaaaaaaaaaaaaaargh
paralysé	paralyzed
foudroyante	jumping
aveuglé	blinded
titubant	staggering
galopaient	prancing
s'atténue	dims
aidant	helping
saphirs	sapphires
délavés	faded
sûre	safe
temps-ci	time
firenze	firenze
pliant	folding
galop	gallop
flancs	sides
palpitants	exciting
couverts	covered
mule	mule
vaudra	worth
serment	oath
frappant	striking
sabot	shoe
qu'avons-nous	what have we
soumettent	submit
décrets	decrees
ânes	donkeys
égarés	lost
ruer	rush
tuée	killed
dévoilé	unveiled
dresse	provides
cache	cache
aide	using
m'as	me
ralentit	slows down
basses	low
poursuivirent	continued
traversaient	crossed
n'utilisons	do not use
crins	horsehair
monstrueuse	monstrous
crime	crime
permet	allows
touchent	touch
demi-vie	half-life
parsemait	parsemait
maudit	cursed
redonne	restores
permette	allow
connais-tu	do you know
guetter	watch
buffle	buffalo
machinalement	going through the motions
quitte	leaves
trompe	wrong
lisant	reading
frissonnant	shivering
écouta	listened to
l'attend	the expected
pensions	pensions
effrayé	scared
entende	hear
intervenir	intervene
décident	decide
rassurer	reassure
n'osera	do not dare
parlent	speak
branche	branch
douteuse	dubious
epuisés	epuisés
terminées	completed
défit	challenge
pliée	folded
demanderait	ask
hantise	haunting
déroulaient	place
épreuves	tests
écrites	written
neuves	new
empêchait	prevented
utilisateurs	users
tricher	cheat
examen	review
pratique	practice
danser	dance
ananas	pineapple
tabatière	snuff-box
décelait	detected
paniqués	panicked
d'amnésie	amnesia
douleurs	pain
transperçaient	transperçaient
habituelles	the usual
s'ajoutait	added
dégoulinante	dripping
soucis	worries
préoccupés	concerned
absorbés	absorbed
manigances	shenanigans
concernant	on
inventeurs	inventors
rouler	roll
rejoignaient	joined
code	code
1637	1637
l'ascension	the ascension
d'elfric	of elfric
l'insatiable	the insatiable
revue	review
s'allonger	lie
chatouillaient	chatouillaient
tentacules	tentacles
calmar	squid
réchauffait	warmer
eaux	waters
s'étirant	stretching
tranquillité	peace
frottait	rubbing
signifie	means
m'était	I was
avertissement	warning
menace	threat
détends-toi	relax
parages	area
laissera	leave
jouera	play
l'expliquer	explain
relire	read
l'examen	review
malaise	discomfort
trahirait	would betray
révélerait	would
allions	were going to
hâtait	hastening
d'élever	to raise
racontes	talking about
écosser	shell
pressés	in a hurry
voyageur	traveller
marchand	merchant
m'occupais	I was
n'arrêtait	never stopped
m'intéressait	I was interested in
qu'après	after
chiens	dogs
doux	soft
mouton	sheep
s'endort	falls asleep
oubliez-le	forget-the
allez-vous	are you going to
aidera	help
empêche	prevents
espéraient	hoped
indiquerait	would
connaissaient	knew
courageusement	bravely
saugrenue	preposterous
habile	clever
urgent	urgent
envolé	flew
renonçant	renouncing
ramasser	pick up
balbutia-t-elle	stammered as she
méfiante	suspicious
rassuré	reassured
répliqua-t-elle	"she retorted
suggère	suggests
retourniez	return
étonnés	surprised
débarquer	land
étouffa	choked
devriez	should
préparez	prepare
veillerai	watch
personnellement	personally
surveillera	monitor
l'attendre	the wait
charger	load
d'attendre	wait
ajouta-t-	added-t-
perchée	perched
terriblement	terribly
accepta	accepted
d'assurer	to ensure
surveillance	monitoring
fonctionna	worked
perdit	lost
difficiles	difficult
tonna-t-elle	thundered down-t-it
j'apprends	I learn
gémit-elle	she moaned
j'attendais	I was expecting
inquiétude	concern
flamboyaient	flamboyaient
n'existera	does not exist
détruire	destroy
atteindre	reach
n'aurai	will not
retarder	delay
mettrai	will
servirai	serve
l'aie	the iea
récupérée	retrieved
m'arranger	fix me
dérangea	disturbed
parcourait	walked in
cahiers	notebooks
affronter	face
vida	vida
l'utiliser	the use
endormir	sleep
redescendu	come back down
évadé	escaped
balader	walk
heure-ci	time
d'endormir	sleep
laisserai	let
allant	from
traite	deals
d'idiot	idiot
interdites	prohibited
meuble	furniture
s'adressant	addressing
petrificus	petrificus
totalus	totalus
joignirent	joined
rigide	rigid
mâchoire	jaw
bougeaient	moved
saucisson	sausage
navrée	the heart-broken
ligoté	tied up
bâillonné	gagged
comprendras	understand
s'enveloppèrent	wrapped themselves
etre	be
obligés	forced
présage	omen
croyaient	believed
ombre	shadow
tapie	tapie
contournant	bypassing
plis	folds
trébucher	tripping
rétrécis	shrunk
gnomes	gnomes
sales	sales
mômes	kids
d'invisible	invisible
rôde	lurking
excellence	excellence
onctueuse	creamy
regrettable	unfortunate
pardonner	forgive
reviens	come back
passeront	will
dérangerai	dérangerai
avancés	advanced
entrebâillée	ajar
redouter	fear
préférez	prefer
voudrai	want to
retentirent	rang
reniflaient	flared and dilated
harpe	harp
mélodie	melody
lourdes	heavy
grogner	growl
faiblirent	faiblirent
débarrassaient	rid
approchèrent	approached
sentirent	felt
brûlant	burning
fétide	foul
l'anneau	the ring
angoisse	anxiety
échelle	scale
corde	rope
l'index	the index
profondeur	depth
joua	played
replongea	dove into the water
l'enjamba	the stepped over
suspendit	suspended
m'arrive	happens to me
n'essayez	do not try
envoyez-la	send the
habitués	accustomed
carré	square
faiblement	low
sauté	skipped
regardez-vous	look at you
péniblement	painfully
atterri	landed
vrilles	tendrils
lianes	creepers
rendent	make
libérer	free
l'immobiliser	the stop
débattaient	struggle
l'emprise	the grip
végétal	plant
resserrait	closing
bougez	move
d'empêcher	to prevent
j'essaye	I try
étreignait	something to do with his
l'humidité	the moisture
allume	turn on
tordant	twisting
sorciÈre	witch
l'agita	the agita
desserrer	loosen
recroquevillait	shrivelled
l'effet	the effect
liberté	freedom
écoutes	listen to
rejoignant	joining
s'engagèrent	enlisted
s'ouvrait	opened
haut-le-cœur	top-the-heart
retrouvaient	were
confus	confused
tintements	ringing
d'ailes	wings
découvrirent	discovered
brillamment	brilliantly
éclairée	lit
d'arche	arch
attaquer	attack
foncent	bump
profonde	deep
inspiration	inspiration
protégea	protected
s'élança	darted
becs	beaks
piquer	prick
subi	suffered
attaque	attack
vinrent	came
rescousse	rescue
vains	in vain
lorsqu'hermione	when hermione
volantes	flying
ouvre	opens
l'ancienne	the old
décollèrent	they took off
zigzaguaient	zigzag
d'arc-en-ciel	arc-en-ciel
aile	wing
attrapée	caught
froissées	creased
indiquée	indicated
cerner	identify
j'essaierai	I will try
partez	go
paume	palm
d'atterrir	landing
débattait	struggling
l'enfonça	pierced
prêts	loans
obscurité	darkness
franchi	crossed
seuil	threshold
éclatante	brilliant
révélant	revealing
échiquier	chessboard
sculptées	carved
apercevaient	saw
serons	will be
s'anima	if anima
coiffée	wearing
casque	helmet
joigne	join
devoir	duty
vexez	vexez
vexe	offend them
dis-nous	tell us
case	check
cases	boxes
occupèrent	occupied
d'avancer	to move forward
ordres	orders
déplacèrent	moved
faiblir	falter
passerait-il	happen
déplace-toi	moves-you
diagonale	diagonal
reine	queen
l'assomma	the knocking both
monture	mount
traîna	dragged
secoué	shaken
alignées	aligned
s'arrangeait	managed the
réfléchissons	think
s'écrièrent	cried
sacrifices	sacrifices
avancer	advance
prendra	will
permettra	will
échec	failure
arrêter	stop
dépêches	news
traînez	drag
bougé	moved
déplaça	moved
couronne	crown
s'écartèrent	if parted
s'inclinant	bowing
dégageant	releasing
ensorcelé	bewitched
répugnante	disgusting
attaqués	attacked
bosse	kicker
enjambèrent	enjambèrent
s'attendaient	expected
d'effrayant	scary
sauront	will
abolira	abolish
pourront	can
d'ortie	nettle
mortels	fatal
d'agonie	of agony
choisis	selected
fuir	flee
éternel	lord
supplice	torment
indices	indices
rusée	sly
perfidie	perfidy
vins	wines
alliée	allied
inégales	uneven
naine	dwarf
sein	within
fatale	fatal
deuxièmes	second
d'aspect	aspect
disparates	disparate
soupir	sigh
logique	logic
énigme	enigma
n'arriveraient	not arrived
contiennent	contain
poison	poison
violettes	purple
utilisez-les	use the
envoyez	send
l'affronter	the face
passera	will
trompes	fallopian
goulot	neck
parcourue	traveled
angoissée	anguished
disparaissent	disappear
j'arrive	I can
contracta	contracted
muscles	muscles
léchèrent	léchèrent
tranquillement	quietly
alliez	go
coupable	guilty
soupçonner	suspect
bégayant	stammering
précipitée	precipitated
visuel	visual
marmonné	mumbled
n'attirait	not attracted
ligotèrent	tied
m'aviez	I had
protégeait	protected
m'empêcher	stop me
manigancer	engineering
reviendra	return
lord	lord
l'offrir	the offer
est-elle	is it
détourne	away
détester	hate
désinvolte	casual
méprisaient	despised
cordialement	cordially
traits	features
convulsèrent	convulsèrent
instructions	instructions
voyageais	traveling
d'idées	ideas
ridicules	ridiculous
faibles	low
fidèlement	faithfully
sévir	crack
pardonne	forgive
erreurs	errors
surveiller	monitor
faiblit	weakening
juron	curse
faut-il	does it
casse	case
conséquent	result
s'aperçoive	notices
aidez-moi	help me
lui-	him-
ligotaient	ligotaient
dites-moi	tell me
mente	mente
racontant	telling
provenir	come
vraie	true
rassembla	together
prétendit-il	claimed it
allait-il	was he going to
s'exprima	expressed
ment	ment
revenez	return
clouait	nailed
remuer	stir
muscle	muscle
défaire	undo
d'émettre	issue
terrifiant	terrifying
fentes	slots
vapeur	steam
partageant	sharing
m'accueillir	welcome me
abreuver	drink
j'aurai	I will have
recréer	recreate
connaîtras	know
suppliant	begging
menteur	liar
reculait	fell
perde	lose
maléfique	evil
émouvant	moving
siffla-t-il	whistle-t-he
j'apprécie	I appreciate
résisté	resisted
bravoure	bravery
meure	die
enflammée	inflamed
attrape-le	catch-the
fendre	crack
débattant	debating
couvraient	covered
d'ampoules	bulbs
brûlés	burned
l'immobilisa	the immobilized
l'écrasant	the crushing
souffrance	suffering
gémit-il	moans-it
incrédule	incredulous
paumes	palms
chair	flesh
tue-le	kills-the
instinctif	instinctive
plaqua	wood, and overlaid
aaaaaaaaaarg	aaaaaaaaaarg
infliger	inflict
glapissements	barking
répétait	repeated
sombra	sombra
lourds	heavy
d'albus	of albus
calme-toi	be quiet, you
quantité	quantity
suffisante	sufficient
admirateurs	admirers
sous-sols	sub-soil
t'amuserait	you have a good time
hygiénique	hygienic
confisqué	confiscated
grandement	greatly
soulagés	relieved
inquiétés	worried
distraire	distract
admirablement	beautifully
reconnais	recognize
venais	had
t'arracher	break away
l'important	the important
l'effort	the effort
craint	fears
d'élixir	elixir
ordre	order
équilibré	balanced
souhaitait	wanted
désirent	wish
désirer	desire
sachant	knowing
chanta	sang
nomme	appoints
qu'accroître	that increase
reprenne	resume
choses-là	things
l'aborder	the address
précautions	precautions
mentirai	lie to you
voulait-il	he wanted to
poses	poses
sauras	'll know
n'aimes	don't like
l'amour	love
amour	love
manifesté	shown
haine	hate
d'ambition	ambition
susciter	generate
manifesta	manifesta
oiseau	bird
s'essuyer	wipe
drap	sheet
possession	possession
aimerais	would like to
haïssaient	hated
rêveur	dreamer
réagissent	react
dette	debt
envers	to
qu'ainsi	that as well
quittes	leave
haïr	hate
m'aies	I've
intelligence	intelligence
surprend	surprises
entamais	started
prive	prive
caramel	caramel
tousser	cough
charmante	charming
supplia	begged
repose	based
retint	retained
allais	was going to
souci	concern
circonstances	circumstances
passionnante	exciting
détaillé	detailed
omettre	omit
public	public
étouffant	stuffy
cinglé	crazy
ranimé	revived
foncé	dark
projet	project
fonctionnait	worked
dingue	crazy
quart	quarter
d'heure	time
réplique	replica
persuadée	convinced
visiteur	visitor
rapport	report
chevet	bedside
sanglota-t-il	sanglota-t-he
dite	the so-called
boirai	drink
m'envoyer	send me
couler	flow
l'oubliez	forget
prononce	pronounced
prenez	take
sandwich	sandwich
congé	leave
reliure	binding
page	page
adressant	sending
insisté	insisted
septième	seventh
consécutive	consecutive
déployée	deployed
symbole	symbol
s'évanouit	faints
importuner	annoy
bavardages	chatter
vieillard	old man
entamions	may take
qu'auparavant	as before
décerner	award
décompte	count
cinquante-deux	fifty-two
vingt-six	twenty-six
soixante-douze	seventy-two
d'applaudissements	applause
d'acclamations	to cheers
trépignements	trépignements
triomphants	triumphant
commencerai	start
radis	radish
jouée	played
nombreuses	many
parurent	appeared
frémir	simmer
redoutables	formidable
j'accorde	I grant
parlons	let's talk about
sang-froid	in cold blood
manifestés	manifested
additions	additions
s'égosillant	if égosillant
aequo	tie
l'extérieur	outside
explosion	explosion
acclamer	cheering
embrassades	hugs
jusqu'alors	until then
décoration	decoration
remplacé	replaced
altier	altier
égard	respect
contrariété	annoyance
redeviendrait	would
l'être	the be
vaincu	defeated
garderait	keep
botanique	botanical
rattrapait	just catching up
catastrophique	catastrophic
armoires	cabinets
vidèrent	had
prêtes	ready
s'égara	get lost
prévenaient	warned
ramenait	back
paysage	landscape
verdoyant	green
remettre	back
vestes	jackets
blousons	jackets
ridé	corrugated
n'attirent	do not draw
surgissant	arising
d'affoler	of panic
veniez	come
enverrai	send
bousculaient	a huge crowd
replongeaient	replongeaient
fuser	fuser
malpoli	rude
moustachu	mustache
passeras	pass
m'amuser	I'm having fun
rowling	rowling
1967	1967
chepstow	chepstow
comté	county
gwent	gwent
galles	wales
l'université	the university
d'exeter	exeter
diplômée	graduate
littérature	literature
françaises	French
travaillé	worked
l'association	the association
amnesty	amnesty
international	international
enseigné	taught
français	French
1990	1990
germer	sprout
exceptionnellement	exceptionally
crayon	pencil
noter	note
lectrice	reader
boulimique	bulimic
souvient-elle	she
transmis	transmitted
j'écrivais	I wrote
regrette	regrets
épisode	episode
tenais	wanted
assistante	assistant
maître-auxiliaire	master-auxiliary
paris	paris
expérience	experience
renouveler	renew
portugal	portugal
enseigner	teach
l'anglais	English
chapitres	chapters
épousé	married
journaliste	journalist
portugais	Portuguese
jessica	jessica
divorce	divorce
link	link
Édimbourg	Edinburgh
studio	studio
chômage	unemployment
consacrée	dedicated
l'écriture	writing
s'endorme	went to sleep
poussette	stroller
éparpillait	éparpillait
roman	novel
achevé	completed
manuscrit	manuscript
agents	agents
littéraires	literary
essuyer	wipe
solde	balance
proposer	offer
offre	offers
l'exclusivité	the exclusivity
agent	agent
enchères	auction
etats-unis	united states
avance	advance
versée	paid
auteur	author
angleterre	england
l'étranger	the foreign
parution	release
couronné	crowned
smarties	smarties
book	book
award	award
national	national
children's	children's
figuré	figured
prestigieuses	prestigious
sélections	selections
compare	compare
roald	roald
dahl	dahl
best-sellers	best-sellers
lecteurs	readers
