chapitre	chapter
17	17
décret	decree
d’éducation	education
n	n
/	/
24	24
harry	harry
se	is
sentit	felt
plus	more
heureux	happy
durant	during
le	the
reste	rest
du	the
week-end	weekend
qu’il	it
ne	do
l’a	the
été	been
pendant	during
tout	all
l’année	the year
ron	ron
et	and
lui	him
passèrent	passed
une	a
grande	great
partie	part
de	of
leur	their
dimanche	Sunday
à	to
rattraper	catch up
encore	yet
fois	time
retard	delay
dans	in
leurs	their
devoirs	duties
ceci	this
peut	can
difficilement	hardly
être	be
considéré	considered
comme	as
un	a
programme	program
réjouissant	pleasing
mais	but
soleil	sun
d’automne	autumn
persistait	persisted
dernier	last
éclat	glow
au	the
lieu	place
rester	stay
voûtés	vaulted
sur	on
les	the
tables	tables
la	the
salle	room
commune	common
ils	they
choisirent	chose
d’emmener	take
travail	work
dehors	outside
s’allonger	lie
paresseusement	lazily
l’ombre	the shadow
d’un	a
grand	great
hêtre	beech
bord	edge
lac	lake
hermione	hermione
qui	that
bien	well
sûr	course
était	was
point	point
ses	its
amena	brought
beaucoup	a lot
laine	wool
avec	with
elle	it
jeta	threw
sort	fate
aiguilles	needles
tricoter	knitting
afin	in order
qu’elles	they
s’élèvent	amount
au-dessus	above
d’elle	it
brillant	brilliant
cliquetant	clicking
pour	for
produire	produce
chapeaux	hats
d’écharpes	scarves
savoir	know
qu’ils	they
étaient	were
en	in
train	train
faire	do
quelque	some
chose	thing
résister	resist
umbridge	umbridge
ministère	department
que	that
stratégique	strategic
rébellion	rebellion
donnait	gave
celui-ci	it
sentiment	feeling
d’immense	huge
satisfaction	satisfaction
il	it
n’arrêtait	never stopped
pas	not
revivre	relive
par	by
pensée	thought
rencontre	meeting
samedi	Saturday
toutes	all
ces	these
personnes	people
venues	come
apprenne	learn
défense	defence
contre	against
forces	forces
mal	evil
l’expression	the expression
visages	faces
quand	when
écoutaient	listened to
choses	things
avait	had
faites	do
cho	cho
faisait	was
l’éloge	praise
sa	its
performance	performance
tournoi	tournament
des	of
trois	three
sorciers	wizards
-	-
considéraient	saw
menteur	liar
farfelu	wacky
quelqu’un	someone
mérite	merit
d’être	to be
admiré	admired
réchauffa	warmed
tellement	so
coeur	heart
joyenux	joyenux
lundi	Monday
matin	morning
malgré	despite
l’imminence	the imminence
cours	during
aimait	loved
moins	less
descendirent	went down
escaliers	stairs
mènent	lead
dortoir	dormitory
discutant	discussing
l’idée	the idea
d’angélina	angélina
doivent	must
travailler	work
nouvelle	new
tactique	tactical
appelée	called
sloth	sloth
grip	grip
roll	roll
(sloth=paresse	(sloth=laziness
grip=prise	grip=grip
roll=rouleau)	roll=roll)
l’entraînement	training
quidditch	quidditch
ce	this
soir	evening
c’est	it is
seulement	only
arrivèrent	arrived
milieu	middle
sous	under
premiers	first
rayons	ray
s’aperçurent	saw
y	there
déjà	already
attiré	attracted
l’attention	attention
petit	small
groupe	group
affiche	displays
fixée	fixed
panneau	panel
gryffondor	gryffindor
si	if
qu’elle	it
recouvrait	covered
affiché	posted
listes	lists
livres	books
d’occasions	opportunities
vendre	sell
rappels	reminders
réguliers	regular
règles	rules
l’école	the school
d’argus	argus
rusard	rusard
l’emploi	employment
temps	time
entraînements	workouts
offres	offers
d’échanges	exchange
cartes	cards
chocogrenouilles	chocolate frog
dernière	last
publicité	advertising
weasley	weasley
engager	commit
testeurs	testers
dates	dates
week-ends	weekends
pré-	pre-
au-lard	the-bacon
objets	objects
trouvés	found
ou	or
perdus	lost
imprimée	printed
gros	wholesale
caractères	characters
noirs	black
cachet	stamp
l’air	the air
très	very
officiel	official
bas	the bottom
l’affiche	the poster
côté	side
d’une	a
signature	signature
bouclée	curly
nette	net
ordre	order
inquisiteur	inquisitor
poudlard	hogwarts
organisations	organizations
communautés	communities
équipes	teams
groupes	groups
clubs	clubs
d’élèves	students
sont	are
dorénavant	now
suspendus	suspended
organisation	organization
communauté	community
équipe	team
club	club
est	is
défini	set
présente	this
déclaration	declaration
régulière	regular
élèves	students
permission	permission
rencontrer	meet
demandée	requested
(professeur	(professor
umbridge)	umbridge)
aucune	no
exister	exist
sans	without
l’approbation	the approval
élève	student
sera	will be
pris	taken
former	form
d’appartenir	to belong
n’a	did
approuvé	approved
renvoyé	returned
précité	above
conformité	compliance
educatif	educational
numéro	number
vingt-quatre	twenty-four
signé	signed
dolores	dolores
jane	jane
lurent	read
par-dessus	above
têtes	heads
deuxième	second
année	year
avaient	had
angoissés	anxious
est-ce	is this
ça	it
veut	wants to
dire	say
vont	go
devoir	duty
fermer	close
gobstones	gobstones
(gob=crachat	(gob=sputum
stones=pierres)	stones=stones)
demanda	asked
l’un	one
d’entre	of
eux	them
son	its
ami	friend
je	I
pense	think
ira	ira
dit	said
sombrement	darkly
faisant	making
sursauter	jump
crois	believe
nous	we
aurons	will
autant	as much
chance	chance
fait	fact
hein	eh
demanda-t-il	he asked
s’étaient	had
enfuis	fled
relire	read
joie	joy
l’avait	had
envahi	invaded
depuis	since
pouls	pulse
battait	beat
rage	rage
corps	body
n’est	there is
coïncidence	coincidence
dit-il	he said
serrant	tightening
poings	fists
courant	current
immédiatement	immediately
gens	people
pub	pub
sois	am
réaliste	realistic
on	it
sait	knows
vraiment	really
digne	worthy
confiance	trust
l’une	one
a	has
pu	could
partir	from
raconter	tell
pensé	thought
l’avaient	had
cru	raw
même	even
zacharias	zacharias
smith	smith
suite	suite
tapant	typing
doigt	finger
main	hand
michael	michael
corner	corner
regard	look
louche	ladle
aussi	also
me	me
demande	request
vu	seen
retournant	returning
vers	to
porte	door
mène	leads
filles	girls
allons	will
avança	advanced
bond	bond
ouvrit	opened
s’engouffra	rushed
l’escalier	the stairs
colimaçon	spiral
sixième	sixth
marche	walking
entendit	heard
fort	fort
grincement	grinding
ressemblait	looked like
bruit	noise
klaxon	horn
marches	steps
s’assemblèrent	gathered themselves together
longue	long
pente	slope
pierre	stone
lisse	smooth
toboggan	slide
eut	had
bref	brief
moment	time
lequel	which
essaya	tried
continuer	continue
courir	run
tomba	fell
créa	created
gisant	lying
dos	back
aux	the
pieds	feet
euh	uh
j’	j’
qu’on	we
ait	has
droit	right
d’aller	go
remettant	delivering
essayant	trying
rire	laugh
deux	two
quatrième	fourth
vinrent	came
piallier	piallier
joyeusement	happily
ooooh	ooooh
essayé	tried
monter	mount
gloussèrent-elles	gloussèrent-they
gaiement	merrily
relevant	under
lorgnant	peeping
moi	me
ébouriffé	ruffled
n’aurais	would have
jamais	never
arriverait	happen
juste	just
ajouta-t-il	he added
sortirent	went out
portrait	portrait
toujours	always
gloussant	chuckling
folles	crazy
venir	come
notre	our
comment	how
eh	eh
vieille	old
règle	rule
dépassée	exceeded
venait	came
glisser	drag
habilement	skillfully
tapis	carpet
devant	before
relever	meet
écrit	written
l’histoire	the story
fondateurs	founders
estimaient	felt
garçons	boys
dignes	worthy
cas	case
pourquoi	why
avez-vous	have you
là-haut	up there
te	te
voir	see
regarde	look at
traînant	dragging
yeux	eyes
d’hermione	of hermione
glissèrent	glissèrent
rapidement	quickly
haut	top
devint	became
dur	hard
dû	due
colère	anger
peuvent	can
avoir	have
voix	voice
basse	low
tu	you
es	es
trop	too
naïve	naive
penses	think
parce	because
personne	person
honorable	honourable
non	not
j’ai	I
jeté	cast
morceau	song
parchemin	parchment
avons	have
tous	all
acharnement	hard
crois-moi	believe me
s’il	if it
ont	have
couru	ran
saura	will
exactement	exactly
regretter	regret
qu’est-ce	what is this
va	will
arriver	getting
avidement	eagerly
mots	words
d’eux	of them
boutons	buttons
d’acné	acne
d’eloïse	eloise
midgeon	midgeon
auront	will
d’adorables	adorable
tâches	tasks
rousseur	freckles
bon	good
allons-y	let's go
descendons	go down
prendre	take
déjeuner	breakfast
verrons	see
autres	other
maisons	houses
c’était	it was
évident	obvious
entrant	incoming
d’umbridge	of umbridge
n’avait	had
placardée	plastered
tour	tour
intensité	intensity
étrange	strange
conversations	conversations
d’agitation	agitation
fur	as
mesure	measurement
levaient	rose
s’asseyaient	sat
table	table
s’entretenant	talking
lu	read
peine	penalty
rejoint	joined
sièges	seats
neville	neville
dean	dean
fred	fred
george	george
ginny	ginny
vous	you
avez	have
croyez	believe
regardaient	watched
regarda	looked at
autour	around
qu’aucun	no
professeur	professor
n’était	there was
près	near
continue	continues
calmement	calmly
savais	knew
dirais	would say
air	air
réjoui	pleased
donnant	giving
tape	tape
bras	arm
préfets	prefects
regardant	looking at
narquois	mocking
répondit	replied
froidement	coldly
voilà	this is
ernie	ernie
hannah	hannah
abbott	abbott
épaule	shoulder
types	types
serdaigle	ravenclaw
aucun	no
boutonneux	pimply
alarmée	alarmed
fiche	sheet
idiots	idiots
ici	here
maintenant	now
aura	will
asseyez-vous	sit
murmura-t-elle	she whispered
gestes	gestures
frénésie	frenzy
rejoignent	join
poufsouffle	hufflepuff
tard	later
parlera	talk
vais	'll
mickael	mickael
impatience	impatience
balançait	rocking
banc	bench
quel	what
imbécile	fool
précipita	rushed
assise	sitting
loin	far
parlait	spoke
cette	this
amie	friend
cheveux	hair
frisés	curly
amené	led
hog’s	hog's
head	head
(jeu	(game
hogshead=barrique	hogshead=barrel
head=tête	head=head
cochon)	pig)
l’avertissement	the warning
pourrait	could
l’effrayer	the scare
l’empêcher	prevent
nouveau	new
rencontres	meetings
répercussions	impact
n’étaient	there were
calmées	calmed down
quittèrent	left
d’histoire	history
magie	magic
angélina	angélina
courait	ran
ayant	having
complètement	completely
désespérée	desperate
ok	ok
fut	was
assez	enough
l’entendre	hear
rendez	visit
compte	account
inclut	includes
parlant	speaking
doit	must
demander	ask
reformer	reform
l’équipe	the team
griffondor	griffondor
quoi	what
hors	out
question	question
consterné	appalled
mentionne	mentions
donc	so
écoute	listening
dis	say
plaît	please
mets	mets
laissera	leave
jouer	play
d’accord	agreement
alors	then
qu’angélina	that angélina
semblait	seemed
larmes	tears
t’inquiète	don't worry
contrôler	control
parie	bet
mécontent	unhappy
mirent	started
route	road
binns	binns
inspecté	inspected
j’te	I'm
n’importe	any
là	there
tort	wrong
seul	only
présent	this
entrèrent	went
flottait	floated
quelques	a few
centimètres	centimeters
chaise	chair
d’habitude	usually
préparait	preparing
discours	speech
monotone	monotonous
guerres	wars
géants	giants
fit	fit
effort	effort
suivre	follow
disait	said
aujourd’hui	today
griffonnait	griffonnait
négligemment	carelessly
ignorant	ignoring
coups	shots
d’oeil	eye
fréquents	frequent
coude	elbow
coup	blow
particulièrement	particularly
douloureux	painful
côtes	coast
tête	head
pointa	pointa
fenêtre	window
hedwige	hedwig
perchée	perched
rebord	rim
étroit	close
regardait	watched
travers	through
mince	thin
vitre	glass
lettre	letter
attachée	attached
patte	paw
comprenait	included
venaient	came
diable	devil
avait-elle	had she
donnée	given
moment-là	time
pointaient	pointed
entre	between
oh	oh
adoré	loved
chouette	owl
belle	beautiful
lavande	lavender
soupirer	sigh
parvati	parvati
oeil	eye
continuait	continued
lire	read
notes	notes
rendant	making
absolument	absolutely
classe	class
glissa	slipped
silencieusement	silently
s’accroupit	squats
remonta	came up
rangée	row
jusqu’à	up to
attrapa	caught
poignée	handle
l’ouvrit	the opened
lentement	slowly
espéré	hoped
qu’hedwige	that hedwig
aurait	would
tendu	tense
puisse	can
détacher	detach
serait	would be
ensuite	then
envolée	soaring
volière	aviary
dès	as soon
suffisamment	enough
ouverte	open
l’intérieur	inside
hululement	howling
plaintif	the plaintive
ferma	closed
anxieux	anxiety
puis	then
dépêcha	dispatched
rejoindre	join
siège	seat
assis	sitting
posa	posa
genoux	knees
mit	mit
s’aperçut	saw
plumes	feathers
d’hedwige	of hedwig
étrangement	strangely
ébouriffées	ruffled
certaines	some
pliées	folded
mauvais	bad
sens	meaning
ailes	wings
formait	formed
angle	angle
bizarre	weird
blessée	injured
murmura	whispered
cachant	hiding
derrière	behind
penchèrent	immediately
laissa	let
tomber	fall
plume	pen
regardez	watch
aile	wing
tremblait	shaking
voulut	wanted
toucher	touch
gonfla	gonfla
reproche	reproach
haute	high
monde	world
retourna	returned
leva	rose
surpris	surprised
s’attendait	expected
face	in the face of
pleine	full
sentez	feel
répéta-t-il	he kept telling her
brumeuse	misty
fermement	firmly
mettant	putting
cachée	hidden
vaut	worth
mieux	better
rende	make
l’infirmerie	the infirmary
oui	yes
l’aise	comfortable
allez-y	go for it
mon	my
garçon	boy
l’extérieur	outside
remit	gave
courut	ran
couloir	hallway
s’arrêtant	stopping
réfléchir	think
vue	view
première	first
vint	came
concernant	on
capable	able
soigner	treat
hagrid	hagrid
étant	being
donné	given
idée	idea
l’endroit	the place
où	where
pouvait	could
trouver	find
seule	only
solution	solution
restante	remaining
gobe-planche	gobbles-board
espérer	hope
voudra	want to
l’aider	the help
sol	soil
couvert	covered
brumeux	misty
n’y	there
signe	sign
alentours	around
cabine	cabin
donner	give
certainement	certainly
professeurs	teachers
dévala	ran down
hululait	hululait
faiblement	low
chaque	each
oscillation	oscillation
gargouilles	gargoyles
entouraient	surrounded
s’approcha	approached
elles	they
rauque	hoarse
devrais	should
fiston	son
urgent	urgent
sèchement	curtly
ooooooh	ooooooh
n’est-ce	is this
l’autre	the other
gargouille	gargoyle
remet	delivers
place	place
frappa	hit
s’ouvrit	opened
retrouva	found
macgonagall	macgonagall
n’avez	do
eu	had
retenue	withholding
dit-elle	she said
lunettes	glasses
carrées	square
manière	way
alarmante	alarming
hâte	looking forward
n’êtes-vous	are you
apparemment	apparently
seconde	second
cherche	looking
expliqua	explained
ma	my
dites-vous	tell you
apparut	appeared
l’épaule	the shoulder
fumant	smoking
pipe	pipe
tenant	taking into
gazette	gazette
soulevant	lifting
précaution	caution
arrivée	arrival
après	after
hiboux	owls
postaux	postal
drôle	funny
d’allure	look
maintint	maintained
dents	teeth
prit	took
mains	hands
hmm	hmm
grubbly-plank	grubbly-plank
remuant	stirring
légèrement	slightly
dirait	looks like
attaquée	attacked
saurais	would
cela	this
thestrals	thestrals
(intraduisible	(untranslatable
invention	invention
rowling	rowling
chevaux	horses
volants)	ruffles)
cherchent	seek
parfois	sometimes
attraper	catch
oiseaux	birds
sorte	so
soient	are
entraînés	trained
savait	knew
fichait	didn't care
faisaient	were
voulait	wanted
allait	would
s’en	in
sortir	out
cependant	however
brusquement	suddenly
savez	know
d’où	where
vient	comes
potter	potter
londres	london
regards	looks
croisèrent	crossed
brièvement	briefly
sut	sut
dont	which
sourcils	eyebrows
froncèrent	froncèrent
compris	including
12	12
grimmauld	grimmauld
sortit	went out
monocle	monocle
robe	dress
vissa	vissa
d’examiner	review
l’aile	the wing
remettre	back
l’ordre	the order
laissez	let
devrait	should
voler	fly
longues	long
distances	distances
jours	days
merci	thank you
cloche	bell
sonna	rang
pause	break
rien	nothing
ton	your
bourru	gruff
rentrant	returning
minute	minute
wihelmina	wihelmina
oublié	forgot
attaché	attached
tendit	handed
disparut	disappeared
emportant	taking
fixait	set
croire	believe
laissait	left
sentant	feeling
coupable	guilty
aller	go
rappela	reminded
gauche	left
droite	right
arrivaient	arrived
directions	directions
ayez	have
l’esprit	the spirit
rivés	riveted
canaux	channels
communication	communication
épiés	controlled
l’oubliez	forget
flot	stream
affluant	tributary
presque	almost
arrivé	arrived
donna	donna
brusque	sudden
retira	retired
laissant	leaving
entraîné	led
cour	court
foule	crowd
aperçut	saw
debout	standing
coin	corner
abrité	housed
col	col
cape	cape
redressé	restated
protéger	protect
vent	wind
déroula	took place
précipitant	precipitating
découvrit	discovered
cinq	five
sirius	sirius
heure	time
endroit	place
anxiété	anxiety
portée	scope
l’as-tu	did you
emmenée	her
rencontré	met
écoutez	listen
raconta	told
surprise	surprise
parut	appeared
choqué	shocked
contraire	contrary
échangèrent	exchanged
significatifs	significant
j’étais	I was
d’intercepter	intercept
veux	want to
vol	flight
vrai	true
prenant	taking
patmol	patmol
cheminée	fireplace
evidemment	of course
lisait	read
troublée	troubled
j’espère	I hope
d’autre	on the other
lue	read
cachetée	sealed
convaincre	convince
comprendre	understand
parlé	spoken
avant	before
sais	know
anxieusement	anxiously
sac	bag
épaules	shoulders
difficile	difficult
recacheter	recacheter
rouleau	roll
grâce	thanks
épie	being spied on
communications	communications
poudre	powder
cheminette	cheminette
toute	any
façon	how
vois	see
prévenir	prevent
message	message
soit	either
intercepté	intercepted
traînèrent	dragged
donjon	dungeon
potions	potions
pensées	thoughts
atteignirent	reached
furent	were
rappelés	recalled
eux-mêmes	themselves
drago	drago
malfoy	malfoy
tenait	held
rogue	rogue
exhibait	exhibited
nécessaire	necessary
puissent	can
entendre	hear
mot	word
serpentards	serpentards
attendre	wait
suis	am
allé	gone
automatique	automatic
voyez	see
connaît	knows
père	father
passe	pass
souvent	often
intéressant	interesting
seront	will be
autorisés	authorized
répondez	answer
implorant	imploring
poussant	pushing
gris	grey
vicieusement	viciously
direction	management
d’influence	influence
aient	have
moindre	less
d’après	after
m’a	me
excuse	excuse
renvoyer	return
arthur	arthur
années	years
concerne	for
petite	small
l’enferment	lock
sainte	holy
mangouste	mongoose
cellule	cell
spéciale	special
cerveau	brain
détraqué	crank
expression	expression
grotesque	grotesque
bouche	mouth
moitié	half
roulaient	rolled
crabbe	crabbe
goyle	goyle
poussaient	grew
habituels	usual
grognements	grunts
pansy	pansy
parkinson	parkinson's
jubilait	was jumping up and down
heurta	hit
durement	hard
projetant	projecting
réalisa	realized
bousculé	rushed
ainsi	as well
foncer	create
malefoy	malfoy
bondit	leaps
débattait	struggling
frénétiquement	frantically
battant	flying
tentant	tempting
désespérément	desperately
d’atteindre	to achieve
extrêmement	extremely
bouleversé	upset
aide-moi	help me
lança	launched
passer	pass
cou	neck
reculer	back
préparer	prepare
prêt	loan
battre	beat
saisit	captures
ensemble	all
parvinrent	managed
traîner	hanging out
rangs	ranks
visage	face
rouge	red
écarlate	scarlet
pression	pressure
exerçait	exercised
gorge	throat
rendait	made
parfaitement	perfectly
incompréhensible	incomprehensible
bizarres	weird
saint-mangouste	saint-mongoose
montrer	show
luttait	fought
bat	beats
londubat	londubat
froide	cold
méprisante	contemptuous
dix	ten
points	points
relâchez	release
regarder	watch
haletant	panting
devais	had to
t’arrêter	stop
souffla	blew
ramassant	picking up
t’auraient	you would have
réduit	reduced
bouillie	boiled
ramassa	picked up
geste	gesture
partit	left
barbe	beard
merlin	merlin
doucement	gently
suivaient	followed
sujet	about
sainte-mangouste	sainte-mongoose
dommages	damage
cérébraux	brain
dus	due
pénible	painful
juré	juror
dumbledore	dumbledore
secret	secret
rejoignirent	joined
fond	background
parchemins	scrolls
exemplaires	best
1000	1000
herbes	herbs
magiques	magic
champignons	mushrooms
murmurer	whisper
bang	bang
répercuta	echoed
écho	echo
tut	tut
remarquerez	notice
invitée	invited
sombre	dark
vit	lives
l’écritoire	the inkstand
levés	surveys
detestait	detestait
triompher	triumph
poursuivre	continue
potion	potion
force	force
trouverez	find
vos	your
mixtures	mixtures
laissées	left
lors	when
correctement	properly
devraient	should
mûri	matured
semaine	week
instructions-	instructions-
agita	agita
baguette-	wand-
tableau	table
passa	spent
demi-heure	a half-hour
envie	want
interroger	question
attention	attention
préparation	preparation
sang	blood
salamandre	salamander
gémit	moans
retenant	retaining
poignet	wrist
d’ajouter	add
ingrédient	ingredient
troisième	third
jus	juice
grenade	granada
vaguement	vaguely
reposant	based
bouteille	bottle
continuant	continuing
lever	sunrise
ha	ha
avançait	advanced
grands	great
lignes	lines
bureaux	offices
penché	leaning
au-	at-
dessus	top
chaudron	cauldron
thomas	thomas
semble	seems
plutôt	rather
avancé	advanced
niveau	level
recommandé	recommended
enseigner	teach
préférerait	would prefer
rayée	striped
redressa	straightened
enseignez-vous	teach you
demanda-t-elle	he asked as she
maintenue	maintained
quatorze	fourteen
ans	years
rétorqua	" 
insondable	unfathomable
attentivement	carefully
ajouta	added
gouttes	drops
siffla	hissed
dangereusement	dangerously
turquoise	turquoise
l’orange	the orange
postuliez	postuliez
premier	first
poste	post
échoué	failed
lèvres	lips
retroussèrent	retroussèrent
moue	pout
gribouilla	scrawled
écritoire	inkstand
régulièrement	regularly
postulé	applied
êtes	are
bougeant	moving
quelconque	any
raison	reason
laquelle	which
constamment	constantly
refusé	refused
nommer	name
propose	offers
alliez	go
saccadée	jerky
doux	soft
sourire	smile
suppose	guess
l’importance	the importance
rétrécissant	narrowing
pofesseur	professor
connaissance	knowledge
approfondie	in-depth
antécédents	history
marcha	walked
commença	started
questionner	question
tourna	turned
reporta	re-scheduled
hâtivement	hastily
coagulait	coagulait
immonde	foul
échapper	escape
odeur	smell
forte	strong
caoutchouc	rubber
brûlé	burned
méchamment	wickedly
vidant	emptying
mouvement	movement
baguette	wand
m’écrirez	me write
essai	test
composition	composition
correcte	correct
indiquant	indicating
trompé	wrong
donnerez	give
prochain	next
furieusement	furiously
entraînement	training
annonçait	announced
paire	pair
nuits	nights
blanches	white
impossible	impossible
réveillé	woke up
journée	day
finisse	finish
peut-être	maybe
pourrai	can
défiler	scroll
divination	divination
triste	sad
allaient	would
fouettant	whisking
l’ourlet	the hem
robes	dresses
ferais	would
semblant	pretend
malade	sick
l’essai	the test
n’aurai	will not
éveillé	awake
nuit	night
peux	can
sécher	dry
sévèrement	severely
ecoute-la	listen to the
parler	talk
t’es	you're
enfuie	ran away
détestes	hate
trelawney	trelawney
indigné	indignant
déteste	hate
épouvantable	terrible
véritable	true
impostrice	impostrice
raté	missed
permettre	allow
d’en	to
rater	miss
autre	other
pouvoir	power
l’ignorer	ignore
rejoignit	joined
chaude	hot
atmosphère	atmosphere
parfumée	scented
trelawnay	trelawnay
l’interprétation	the interpretation
rêves	dreams
pensa	thought
sûrement	surely
passé	past
punition	punishment
essayer	try
tas	heap
inventés	invented
mauvaise	bad
humeur	mood
claqua	slammed
violemment	violently
exemplaire	copy
située	located
s’éloigna	walked away
pincées	plucked
l’exemplaire	the copy
suivant	following
livre	book
seamus	seamus
évitant	avoiding
peu	little
poussa	pushed
poitrine	chest
telle	such
pouf	pouf
continuons	continue
d’hystérique	of hysterical
faut	must
suis-je	am I
médiocre	poor
appris	learned
ouvrir	open
toue	toue
perplexe	puzzled
crut	believed
passait	passed
long	long
dossier	folder
magnifiques	beautiful
remplis	filled
approcha	approached
reçu	received
résultats	results
inspection	inspection
étouffée	choked
(lavande	(lavender
trelawney)	trelawney)
a-t-il	there
euh-	uh-
cria	cried
frissonnant	shivering
d’émotion	emotion
insulté	insulted
doute	doubt
insinuations	innuendo
évidemment	of course
inspiration	inspiration
frissonnante	shivering
détourna	away
coulant	flowing
parle	speaks
étranglée	strangulated
seize	sixteen
bons	good
loyaux	loyal
services	services
inaperçu	unnoticed
laisserai	let
insulter	insult
insulte	insult
timidement	timidly
l’établissement	the establishment
profonde	deep
dramatique	dramatic
ceux	those
embrumés	misty
terrestre	land
craint	fears
persécutés	persecuted
-hélas-	-alas-
destinée	for
gosier	throat
tamponna	tamponna
joues	cheeks
mouillées	wet
châle	shawl
mouchoir	handkerchief
brodé	embroidered
manche	sleeve
moucha	blew her nose
nez	nose
peeves	peeves
pff	pff
pouffa	pouffa
dégoûté	disgusted
voulez	want to
parlez	talk
femme	woman
sautant	jumping
perles	beads
colliers	necklaces
éclatantes	brilliant
continuez	continue
gentiment	kindly
votre	your
parcourir	browse
allées	aisles
fuyant	fleeing
murmurant	muttering
menaces	threats
entrecoupées	interspersed
souffles	puffs
choisir	choose
indigne	unworthy
sursis	stay
verra	see
ose-t-elle	dare she
toi	you
commun	common
retrouvèrent	found
mise	update
entra	entered
pièce	room
portant	bearing
noeud	node
papillon	butterfly
velours	velvet
suffisance	adequacy
bonjour	hello
récitèrent-ils	prayed-they
monotonement	is monotonous
baguettes	chopsticks
rangées	rows
soudain	suddenly
fois-ci	time
d’éloigner	away
prenez	take
page	page
trente-quatre	thirty-four
théorie	theory
défensive	defensive
lisez	read
