chapitre	chapter
32	32
hors	out
du	the
feu	fire
'	'
je	I
ne	do
vais	'll
pas	not
n'ai	haven
besoin	need
d'aller	go
à	to
l'infirmerie	the infirmary
veux	want to
il	it
bafouillait	bafouillait
en	in
essayant	trying
d'éloigner	away
brusquement	suddenly
le	the
professeur	professor
tofty	tofty
qui	that
regardait	watched
harry	harry
avec	with
beaucoup	a lot
d'inquiétude	anxiety
après	after
l'avoir	have
aider	help
quitter	leave
hall	hall
d'entrée	input
où	where
tous	all
les	the
élèves	students
regardaient	watched
fixement	staring
-	-
bien	well
monsieur	mr.
'balbutia	'stammered
essuyant	wiping
la	the
sueur	sweat
de	of
son	its
visage	face
vraiment	really
me	me
suis	am
juste	just
endormi	asleep
eu	had
un	a
cauchemar	nightmare
'la	'the
pression	pressure
des	of
examens	reviews
dit	said
vieux	old
magicien	magician
bienveillance	benevolence
tapotant	tapping
sur	on
l'épaule	the shoulder
cela	this
arrive	happens
jeune	young
homme	man
maintenant	now
verre	glass
d'eau	water
glacée	ice
et	and
peut-être	maybe
serez	will be
prêt	loan
retourner	return
au	the
grand	great
l'examen	review
est	is
presque	almost
fini	finished
mais	but
peut-	can-
etre	be
voulez	want to
vous	you
finir	finish
une	a
réponse	response
oui	yes
d'une	a
manière	way
extravagante	extravagant
dire	say
non	not
j'ai	I
fait	fact
ce	this
que	that
pouvais	could
pense	think
"	"
très	very
doucement	gently
j'irai	I will go
prendrai	take
votre	your
feuille	sheet
d'examen	review
suggère	suggests
alliez	go
allonger	lie
bas	the bottom
ferai	will
inclinant	tilting
tête	head
vigoureusement	vigorously
merci	thank you
a	has
seconde	second
talons	heels
vieil	old
disparurent	disappeared
seuil	threshold
monta	went up
l'escalier	the stairs
marbre	marble
courant	current
traversa	crossed
couloir	hallway
si	if
vite	fast
portraits	portraits
qu'il	it
passait	passed
murmuraient	murmured
reproches	blame
finalement	finally
entra	entered
comme	as
ouragan	hurricane
par	by
portes	doors
deux	two
battants	shutters
causant	causing
madame	mrs.
pomfresh	pomfresh
versait	paid
quelque	some
liquide	liquid
brillant	brilliant
bleu	blue
dans	in
bouche	mouth
ouverte	open
montagues	montagues
crier	shout
alarme	alarm
'potter	'potter
pensez-vous	do you think
faire	do
dois	do
voir	see
mcgonagall	mcgonagall
haleta	gasped
souffle	breath
déchirant	ripping
ses	its
poumons	lungs
c'est	it is
urgent	urgent
elle	it
n'est	there is
ici	here
potter	potter
tristement	sadly
été	been
transférée	transferred
ste-mangouste	ste-mongoose
matin	morning
quatre	four
charmes	charms
stupéfixants	stupéfixants
directement	directly
poitrine	chest
âge	age
miracle	miracle
qu'ils	they
l'ont	have
tuée	killed
parti	party
choqué	shocked
cloche	bell
sonna	rang
l'extérieur	outside
dortoir	dormitory
entendait	heard
grondement	rumble
habituel	usual
éloigné	remote
d'étudiants	students
commençant	starting
inonder	flood
d	d
couloirs	corridors
au-dessus	above
au-dessous	below
lui	him
était	was
resté	stayed
là	there
regardant	looking at
terreur	terror
montait	rose
l'intérieur	inside
n'avait	had
personne	person
parler	talk
dumbledore	dumbledore
hagrid	hagrid
s'attendait	expected
toujours	always
ait	has
irascible	irascible
inflexible	inflexible
présente	this
solidement	securely
jen	jen
étonné	surprised
soyez	be
sorte	so
d'approbation	approval
féroce	fierce
d'entre	of
eux	them
avait	had
pu	could
stupefixer	stupefixer
minerva	minerva
lumière	light
jour	day
lâcheté	cowardice
c'était	it was
méprisable	despicable
n'était	there was
inquiète	concerned
arriverait	happen
aux	the
étudiants	students
sans	without
moi	me
démissionnerais	would resign
protestation	protest
yeux	eyes
vides	empty
tournait	turned
autour	around
marchait	walked
grands	great
aveuglément	blindly
vers	to
grouillant	teeming
debout	standing
bousculé	rushed
foule	crowd
panique	panic
s'étendant	extending
gaz	gas
toxique	toxic
pour	for
sa	its
nagé	swam
pouvait	could
penser	think
quoi	what
ron	ron
hermione	hermione
voix	voice
courait	ran
nouveau	new
poussant	pushing
voie	way
se	is
moquant	laughing at
leurs	their
protestations	protests
descendit	went down
étages	floors
toute	any
vitesse	speed
haut	top
quand	when
vit	lives
criant	screaming
derrière	behind
immédiatement	immediately
regard	look
effrayé	scared
qu'est-ce	what is this
arrivé	arrived
va	will
tu	you
est-ce	is this
es	es
malade	sick
es-tu	are you
aller	go
'demanda	'asked
venez	come
rapidement	quickly
avancez-vous	go ahead-you
chose	thing
mena	mena
long	long
rez-de-chaussée	ground floor
embrasures	embrasures
enfin	finally
trouva	found
salle	room
classe	class
vide	empty
laquelle	which
plonga	plonga
fermant	closing
porte	door
voldemorts	voldemorts
sirius	sirius
comment	how
l'ai	I
vu	seen
l'instant	the moment
pendant	during
dont	which
blanc	white
sais	know
'dit	said
exactement	exactly
y	there
pièce	room
département	department
mystères	mysteries
pleins	full
planches	boards
couvertes	covered
ces	these
petites	small
ils	they
sont	are
fin	end
rangée	row
quatre-vingt-dix-sept	ninety-seven
essaye	try
d'utiliser	use
avoir	have
veut	wants to
torture	torture
finira	will
tuer	kill
constata	found
tremblait	shaking
genoux	knees
alla	alla
bureau	office
s'assit	sat
maîtriser	master
allons	will
nous	we
rendre	make
leur	their
demanda	asked
t	t
moment	time
silence	silence
alors	then
'y	there
arrivez	arrive
pouvons	can
sauver	save
fort	fort
faiblement	low
comprendre	understand
pourquoi	why
bâillaient	bâillaient
s'il	if it
demandait	asked
peu	little
raisonnable	reasonable
plutôt	rather
effrayée	scared
er	er
voldemort	voldemort
est-il	is it
entré	entered
ministère	department
magie	magic
quelqu'un	someone
sache	know
pourrais-je	could I
savoir	know
beugla	beugla
question	question
entrer	enter
prenant	taking
cinq	five
heures	hours
l'après-midi	in the afternoon
doit	must
être	be
plein	full
d'employés	employees
sont-ils	are they
entrés	entered
probablement	probably
magiciens	magicians
plus	more
recherchés	searched
monde	world
penses	think
pourraient	could
bâtiment	building
d'aurors	of aurors
détecté	detected
utilisé	used
cape	cape
d'invisibilité	invisibility
ou	or
cria	cried
façon	how
complètement	completely
chaque	each
fois	time
j'y	I
ai	I
n'y	there
jamais	never
tranquillement	quietly
as	as
rêvé	dreamed
cet	this
endroit	place
tout	all
rêves	dreams
normaux	normal
levant	rising
près	near
d'elle	it
tour	tour
voulait	wanted
secouer	shake
explique-tu	"you
père	father
fait-il	it
savais	knew
point	point
probable	likely
désespérément	desperately
diable	devil
pourrait	could
place	place
grimmauld	grimmauld
temps	time
peut	can
craqué	cracked
voulu	wanted
prendre	take
bon	good
bol	bowl
d'air	air
frais	fees
d'un	a
air	air
inquiet	worried
mort	death
d'envie	envy
sortir	out
cette	this
maison	home
depuis	since
éternité	eternity
persista	persisted
utiliser	use
obtenir	get
l'arme	the weapon
soit	either
raisons	reasons
hurla	screamed
soucie	care
mal	evil
savez	know
viens	just
calme	quiet
frère	brother
mangemort	mangemort
n'est-ce	is this
secret	secret
ouais	yeah
garder	keep
enfermé	locked
regarde	look at
désolé	sorry
pleura	wept
aucun	no
signifie	means
n'avons	have
aucune	no
preuve	proof
chacune	each
vos	your
idées	ideas
encore	yet
déterminé	determined
j'allais	I was going to
te	te
que-	that-
critique	critical
-tu	you
sauve-gens	saves-people
regarda	looked at
veux-tu	do you want to
"un	"a
sauve-gens"	saves-people"
semblait	seemed
appréhensive	apprehensive
l'année	the year
dernière	last
exemple	example
lac	lake
tournoi	tournament
devais	had to
petite	small
delacour	delacour
t'es	you're
emporté	away
vague	wave
chaleur	heat
colère	anger
balayant	sweeping
corps	body
d'harry	harry
pouvait-elle	could she
rappeler	remember
bévue	blunder
ta	your
part	share
pétrifié	petrified
chacun	each
pensé	thought
merveilleuse	wonderful
faire-	do-
drôle	funny
travers	through
dents	teeth
parce	because
souviens	remember
disant	saying
j'	j'
avais	had
gaspillé	wasted
agissant	acting
héros	hero
cà	cà
estimes	reckon
agir	act
consterné	appalled
crache	spits
perdons	lose
j'essaye	I try
connaît	knows
pris	taken
ginny	ginny
chambre	room
secrets	secrets
t'amener	bring you
sait	knows
genre	kind
irait	would
l'aide	using
mys-	mys-
n'importe	any
l'a	the
m'y	me
amener	bring
pas-	not-
ont	have
envoyé	sent
l'ordre	the order
poudlard	hogwarts
-et	-and
ton	your
rêve	dream
libera	libera
hurlement	howl
frustration	frustration
s'éloigna	walked away
alarmée	alarmed
comprends	understand
'lui	'he
cauchemars	nightmares
l'occlumency	the occlumency
servait	served
penses-tu	do you think
m'empêché	I prevented
choses	things
qu'elles	they
rÉels	real
piège	trap
obtenu	obtained
d'autre	on the other
sommes	are
seuls	only
peuvent	can
excellent	excellent
correctement	properly
n'as	did
problème	problem
mon	my
toi	you
sauvai	sauvai
detraqueurs	detraqueurs
tourna	turned
soeur	sister
sauvais	running away
basilic	basil
j'avais	I had
passion	passion
acharnement	hard
apprennes	learn
fermer	close
esprit	spirit
appris	learned
n'aurais	would have
n'avais	had
rien	nothing
vu-	having regard to-
t'	t'
dis	say
qu'	that
important	important
aurait	would
diffÉrent	different
savait	knew
venais-	just-
s'ouvrit	opened
curieux	curious
étroitement	closely
suivi	follow-up
luna	luna
d'habitude	usually
dedans	in
accidentellement	accidentally
hé	hey
certitude	certainty
avons	have
reconnu	recognized
hurlez-	scream-
ca	ca
leva	rose
sourcils	eyebrows
a-t-elle	she
fraîchement	freshly
demandais	wondering
seulement	only
peux	can
bientôt	soon
grossier	coarse
sereinement	serenely
jura	jura
retourna	returned
même	even
voulue	desired
conversation	conversation
lovegood	lovegood
attendez	wait
soudainement	suddenly
elles	they
regardèrent	looked
Écoutez	Listen
instamment	urges
devons	must
établir	establish
laissé	left
quartier	district
général	general
t'en	you
prie	pray
plaît	please
vérifions	check
avant	before
chargions	loaded
londres	london
découvrons	discover
donc	so
jure	swear
n'essayerai	do not try
arrêter	stop
viendrai	come
faut	must
t'aider	help
torturé	tortured
perdre	lose
vérifier	check
exigea	demanded
'comment	'how
devrons	will have to
d'umbridge	of umbridge
contact	contact
terrifié	terrified
pensée	thought
emmènerons	take
umbridge	umbridge
loin	far
aurons	will
surveillances	monitors
employer	use
luttant	fighting
clairement	clearly
ferons	will
dites	tell
"sirius"	"sirius"
parlez-vous	are you talking about
boardman	boardman
trapu	stout
répondit	replied
agressivement	aggressively
pouvez	can
autrement	otherwise
suite	suite
allez-vous	are you going to
arriver	getting
l'	the
ignora	ignored
tordant	twisting
mains	hands
ensemble	all
marchant	walking
mesurés	measured
entre	between
bureaux	offices
trouver	find
l'envoyer	send
fausse	false
direction	management
tenir	take
peeves	peeves
terrible	terrible
habitude	usual
dirai	tell
brisent	break
metamorphose	metamorphose
assez	enough
réfléchissant	reflective
pourrais	could
persuader	persuade
rencontre	meeting
chemin	path
marque	brand
sérieux	serious
situation	situation
qu'hermione	as hermione
n'ait	did
objection	objection
destruction	destruction
métamorphose	metamorphosis
tandis	while
forcerons	will force
l'entrée	the entry
extrémité	end
promptement	promptly
déconseiller	not recommended
gens	people
là-bas	there
charge	load
paralysant	chilling
sembla	seemed
rapidité	speed
inventé	invented
mensonge	lie
remarqua	noticed
fred	fred
george	george
projetaient	projected
soient	are
partis	parties
seront	will be
sous	under
glisserons	slip them
pourras	can
pourras-	can-
tiens	want
devrai	will
seul	only
impatient	looking forward
l'offre	the offer
d'hermione	of hermione
l'accompagner	accompany
signe	sign
solidarité	solidarity
fidélité	fidelity
murmura	whispered
eh	eh
faisons	do
minutes	minutes
soulagé	relieved
qu'harry	harry
accepté	accepted
plan	plan
'cinq	'five
suffiront	suffice
allez	go
choquée	shocked
sûr	course
pensais	thought
attendre	wait
dîner	dinner
oh	oh
ça	it
dit-t-elle	she said
vas	vas
chercher	search
retrouvons	find
jeta	threw
commença	started
battre	beat
contre	against
frayer	spawn
dessus	top
rencontra	met
seamus	seamus
dean	dean
saluèrent	greeted
jovialement	jovialement
dirent	said
fete	fete
nuit	night
réjouir	rejoice
entendit	heard
peine	penalty
rua	rua
trou	hole
portrait	portrait
disputaient	arguing
combien	how
bieraubeurre	bieraubeurre
auraient	would
mis	put
couteau	knife
sac	bag
n'aient	have
remarqué	noticed
laissés	left
contribuer	help
collecte	collection
gallions	galleons
harold	harold
dingle	dingle
estime	estimated
vendre	sell
firewhisky	firewhisky
partait	left
déjà	already
tard	later
sautait	jumped
dernier	last
d'escalier	stair
rejoindre	join
Ça	It
chuchota	whispered
qu'un	a
groupe	group
sixième	sixth
année	year
devant	before
éloigner	away
d'ici	here
pouviez	could
commencer	start
déplacer	move
marcha	walked
cheveux	hair
brillants-rouges	brilliant-red
visible	visible
passage	passage
tirant	pulling
poignet	wrist
arrière	rear
creux	hollow
personnage	character
pierre	stone
médiéval	medieval
murmurant	muttering
paroles	lyrics
es-es-tu	es-es-tu
pâle	pale
a-t-il	there
vérité	truth
cicatrice	scar
faisait	was
autant	as much
pensait	thought
donné	given
coup	blow
fatal	fatal
puni	punished
avery	avery
restèrent	stayed
écoutant	listening to
soigneusement	carefully
marmonnements	mumbles
latins	Latin
buste	bust
venir	come
'disait	'said
devez	must
emprunter	borrow
l'autre	the other
escalier	staircase
lancé	launched
pouvaient	could
entendre	hear
plaintes	complaints
écoliers	schoolchildren
revêche	crabby
vois	see
n'a	did
couleur	color
exaspérée	exasperated
convaincante	convincing
marcher	walk
ceux	those
croit	believes
lentement	slowly
réduit	reduced
nouvelle	new
s'être	will be
propager	spread
n'empruntaient	didn
désormais	now
secteur	sector
fut	was
tranquille	quiet
d'y	there
avancèrent	forth
recouvert	covered
dos	back
bout	end
passèrent	passed
n'oubliez	do not forget
signal	signal
quel	what
rapprochant	approximate
doivent	must
weasley	weasley
notre	our
roi"	king"
voient	see
insérait	included
lame	blade
fente	slot
mur	wall
serrure	lock
sauta	jumped
entrèrent	went
inoccupé	unoccupied
lâcha	released
soupir	sigh
soulagement	relief
qu'elle	it
ajouter	add
sécurité	security
supplémentaire	additional
ôtèrent	stripped
précipita	rushed
fenêtre	window
mit	mit
vue	view
cheminée	fireplace
saisi	seized
pot	pot
poudre	powder
floo	floo
pincée	pinch
grille	grid
causa	causa
l'éruption	the eruption
flamme	flame
verte	green
s'	s'
agenouilla	knelt
poussa	pushed
dansant	dancing
crié	shouted
numéro	number
douze	twelve
filer	spinning
venait	came
tomber	fall
noir	black
quoique	though
restés	stayed
fermement	firmly
plantés	planted
plancher	floor
froid	cold
tenait	held
vissés	screwed
tourbillon	whirlpool
cendre	ash
filage	spinning
arrêta	stopped
ouvrit	opened
longue	long
froide	cold
cuisine	kitchen
s'était	had
attendu	expected
préparer	prepare
corops	corops
éclater	burst
estomac	stomach
voyant	light
déserte	deserted
'cria	'cried
répercuta	echoed
sauf	except
minuscule	tiny
traînant	dragging
pieds	feet
gauche	left
pneu	tire
'appela	'called
demandant	asking
souris	mouse
kreacher	kreacher
l'elfe	the elf
rampa	rampa
champ	field
vision	vision
fortement	strongly
enchanté	enchanted
quoiqu'il	even though it
récemment	recently
supporté	supported
blessure	injury
désagréable	unpleasant
étaient	were
lourdement	heavily
bandées	bandaged
garçon	boy
'informa	'informa
volant	steering wheel
furtif	stealth
regards	looks
curieusement	curiously
triomphants	triumphant
venu	come
'exiga	'high road
donna	donna
rire	laugh
poussif	winded
maître	master
sorti	out
caquetait	caquetait
simplement	simply
avertis	warned
entièrement	fully
conscient	aware
possibilité	possibility
d'	d'
infliger	inflict
punition	punishment
inexistante	non-existent
position	position
lupin	lupin
fol	fol
oeil	eye
d'entre-eux	of them
jubilant	jubilant
détournant	diverting
commenca	began
bavarder	chat
maîtresse	mistress
chance	chance
période	period
tenu	view
'hurla	'yelled
s'arreta	stopped
discerner	discern
chauve	bald
forêt	forest
chaise	chair
pauvre	poor
libèra	libèra
caquetètement	caquetètement
reviendra	return
precipita	precipita
dehors	outside
disparu	gone
puisse	can
prononcer	pronounce
simple	simple
malédiction	curse
insulte	insult
senti	felt
grande	great
douleur	pain
sommet	summit
inhala	inhala
suffocant	suffocating
traîné	dragged
jusqu'à	up to
qu'avec	with
soudaineté	suddenness
horrible	horrible
large	wide
l'avait	had
prenez	take
baguette	wand
magique	magic
'aboya	'barked
estima	estima
qu'une	a
main	hand
cherchait	was looking for
tâtons	groping
poche	pocket
robe	dress
enlevait	removed
sienne	siena
aussi	also
bagarre	brawl
auusi	also
êtes	are
secouant	shaking
poing	fist
saisissant	entering
tombe	falls
j'étais	I was
d'obtenir	to obtain
firebolt	firebolt
croassa	croaked
menteur	liar
secoua	shook
garde	guard
stricte	strict
cachots	dungeons
souterrains	underground
aviez	had
avez-vous	have you
communiqué	press release
retirer	remove
plusieurs	several
arraché	ripped
claqua	slammed
lié	related
millicent	millicent
bulstrode	bulstrode
malfoy	malfoy
penché	leaning
l'appui	support
souriant	smiling
satisfait	satisfied
tournoyer	twirl
l'agitation	the hustle and bustle
serpentards	serpentards
tenant	taking into
confusion	confusion
neville	neville
strangulation	strangulation
crabbe	crabbe
l'etouffement	the smothering
avaient	had
bâillonnés	gagged
on	it
warrington	warrington
celui-là	this one
pointa	pointa
doigt	finger
épais	thick
essayé	tried
m'empecher	me to prevent
indiqua	said
essayait	tried
donner	give
pied	foot
tibias	shins
fille	girl
serpentard	slytherin
amené	led
observant	observing
efforts	efforts
semble	seems
sera	will be
uneweasley-free	uneweasley-free
zone	area
ria	ria
sourire	smile
installa	installed
fauteuil	chair
couvert	covered
chintz	chintz
ainsi	as well
-t-elle	she
avez	have
placé	placed
gardes	guards
bouffon	jester
ravages	havoc
parfaitement	perfectly
occupé	busy
mettre	put
l'encre	the ink
objectifs	objectives
télescopes-	telescopes-
m	m
rusard	rusard
m'en	me
ayant	having
informé	informed
l'heure	the time
apparemment	apparently
Était	Was
albus	albus
doute	doubt
entendu	heard
trop	too
quelques-uns	a few
amis	friends
rièrent	rièrent
haine	hate
'cela	'this
parlais	was talking about
gronda-t-il	'oh, come on-it
raidir	stiffen
dangereuse	dangerous
offert	offered
librement	freely
refusé	refused
autre	other
alternative	alternative
forcer	force
'drago	'drago
rogue	rogue
partit	left
lèvres	lips
croire	believe
stupide	stupid
l'oublier	forget
membres	members
l'aider	the help
faux	false
membre	member
phoenix	phoenix
bruits	noise
autres	other
contrôle	control
lèvre	lip
saignait	bleeding
tapis	carpet
luttait	fought
taper	type
fiille	fiille
prise	outlet
tres	very
serré	tight
rouge	red
libérer	free
bras	arm
vain	vain
rejeter	reject
cependant	however
mollement	softly
côté	side
ravisseur	abductor
vaguement	vaguely
s'ennuyait	bored
l'observait	the observed
garda	garda
délibérément	deliberately
expression	expression
drago	drago
malefoy	malfoy
suivie	followed
vousvouliez	vousvouliez
directrice	director
toutes	all
paires	pairs
d'indifférence	indifference
complète	complete
voudrais	would like to
bouteille	bottle
veritaserum	veritaserum
ma	my
interroger	question
l'examinant	the examining
rideaux	curtains
graisseux	fat
noirs	black
'vous	'you
n'avez	do
surement	surely
trois	three
gouttes	drops
suffisantes	sufficient
rougit	blushes
devenant	becoming
douce	soft
furieuse	furious
certainement	certainly
prend	takes
cycle	cycle
lune	moon
mûrir	mature
pouvoir	power
preparer	prepare
mois	months
j'en	I
soir	evening
utilisant	using
communiquer	communicate
personnes	people
inconnu	unknown
montrant	showing
premier	first
d'intérêt	interest
coté	side
m'étonne	amazes me
montré	shown
d'inclination	inclination
suivre	follow
règlement	regulation
intérieur	inside
sombres	dark
froids	cold
concentrait	focused
durement	hard
reve	reve
voulant	wanting to
lise	lise
pensées	thoughts
comprenne	understand
l'interroger	the question
répéta	repeated
tremblant	tremblant
fournissiez	provide
breuvage	beverage
forcera	force
à-coup	a sudden
potion	potion
À	To
moins	less
vouliez	want to
empoisonner	poison
assure	ensures
j'aurais	I would have
sympathie	sympathy
faisiez	did
ennui	boredom
consiste	is
plupart	most
venins	venoms
agissent	act
victime	victim
mots	words
tient	holds
surveillé	monitored
légèrement	slightly
levés	surveys
faites	do
acte	act
délibéré	deliberate
coopération	cooperation
attendait	waiting
mieux	better
lucius	lucius
parle	speaks
positivement	positively
sortez	get out
salut	hi
ironique	ironic
partir	from
train	train
patmol	patmol
'il	'it
l'endroit	the place
s'est	is
caché	hidden
arrêté	stopped
poignée	handle
impatience	impatience
qu'est	that is
impénétrable	impenetrable
compris	including
n'	n'
osait	dare
présence	presence
idée	idea
froidement	coldly
voudrez	want to
sens	meaning
donnerez	give
décodeur	decoder
desserrez	loosen
maintien	maintenance
londubat	londubat
suffoque	suffocates
signifiera	mean
paperasserie	paperwork
ennuyeuses	boring
peur	fear
mentionner	mention
référence	reference
demandez	ask
travail	work
ferma	closed
poigne	grip
laissant	leaving
état	state
trouble	disorder
pire	worst
qu'auparavant	as before
espoir	hope
sentir	feel
soulevait	raised
sortit	went out
discipline	discipline
scolaire	school
elle-meme	itself
nerveusement	nervously
battant	flying
paume	palm
respirant	breathable
sentit	felt
impuissant	helpless
forcez	force
déplaçant	moving
parfois	sometimes
circonstances	circumstances
justifient	justify
l'utilisation	the use
ministre	minister
comprendra	will include
choix	choice
affamée	hungry
sort	fate
cruciatus	cruciatus
desserrer	loosen
langue	language
illégal	illegal
l'écoutait	listened to it
désireux	eager
excité	excited
auparavant	previously
voudrait	would like to
enfreigniez	infringe
loi	law
'cornelius	'cornelius
blessons	hurt
haletait	puff
dirigeait	led
parties	parties
différentes	different
décider	decide
su	su
ordonné	ordered
l'été	the summer
l'expulser	the expel
c'	c'
dse	fsd
quelqu'	someone'
devait	should
respira	breathed
pointé	pointed
front	front
parlaient	spoke
renvoyer	return
celle	the
réalité	reality
sortis	out
aujourd'hui	today
prit	took
profonde	deep
respiration	breathing
cria'	cried'
cruci-	cruci-
forcée	forced
derriere	behind
t'y	you
différence	difference
pleurer	cry
d'essayer	try
l'écraser	the crush
dégoûté	disgusted
triomphant	triumphant
mlle	miss
question-tout	question-any
quelques	a few
réponses	answers
nee	nee
baillon	baillon
respirer	breathe
remarquer	notice
quoiqu'hermione	although hermione
sanglotait	sobbed
trace	trace
larme	tear
supporter	bear
épaules	shoulders
abandonnée	abandoned
penchant	leaning
glapit	"yelped
gela	gela
ouverts	open
orteils	toes
étonnée	surprised
heureusement	fortunately
l'attention	attention
favoris	favorites
concentrée	concentrated
exclusivement	exclusively
signes	signs
soupçonneux	suspicious
sanglota	sanglota
chaudron	cauldron
baveur	leaky
traverse	crosses
balais	brushes
hog's	hog's
head-	head-
idiote	silly
serait	would be
assis	sitting
pub	pub
entier	integer
recherche	search
déception	disappointment
gravée	engraved
ligne	line
affaissée	sagging
avions	aircraft
d'important	important
gémi	moaned
l'angoisse	the anguish
déguiser	disguise
l'absence	the absence
larmes	tears
réapparition	recurrence
soudaine	sudden
d'excitation	excitation
'qu'est	'that is
cherchiez	looking for
pret	pret
étrangla	hanged himself
exiga	high road
arme	weapon
semblaient	seemed to
excités	excited
développé	developed
méthode	method
résistance	resistance
pourriez	could
ordres	orders
o	o
dû	due
finie	finished
m-	m-
l'avons	have
trouvons	find
-ce	-this
trapues	stout
serrées	tight
savons	know
v-v-vraiment	v-v-really
j	j
p	p
d-	d-
dressa	set
exultant	exultant
menez-moi	lead me
montre	watch
eux'	them'
perçant	piercing
conditions	conditions
hemione	hemione
sanglotant	sobbing
laissez-les	let the
j'espère	I hope
l'utiliseront	the use
souhaite	wish
invitiez	request
l'école	the school
servirai	serve
voit	see
l'utiliser	the use
embêter	bother
impact	impact
puissant	powerful
d'oeil	eye
rapide	fast
bombants	bombants
reposant	based
instant	now
tardait	delayed
d'ardeur	ardor
d'avidité	greed
apparu	appeared
contempla	stared at
ensuite	then
parla	spoke
maternelle	maternal
chère	dear
aura	will
prendrons	take
s'occuper	care
fonctionnaire	official
qualifié	qualified
gérer	manage
seule	only
adolescents	teens
restez	stay
retour	return
assurez	make sure
vous-	you-
luna-	luna-
s'échappent	escape
boudeur	sulky
déçu	disappointed
rester	stay
indiquant	indicating
menez	lead
