5	5
le	the
saule	willow
cogneur	slugger
la	the
fin	end
des	of
vacances	holiday
d'été	summer
arriva	came to pass
trop	too
vite	fast
au	the
goût	taste
de	of
harry	harry
bien	well
sûr	course
il	it
avait	had
hâte	looking forward
retourner	return
à	to
poudlard	hogwarts
mais	but
mois	months
qu'il	it
passé	past
terrier	terrier
était	was
moment	time
plus	more
heureux	happy
sa	its
vie	life
ne	do
pouvait	could
s'empêcher	help
d'éprouver	experience
une	a
certaine	some
jalousie	jealousy
l'égard	respect
ron	ron
en	in
pensant	thinking
l'existence	the existence
que	that
lui	him
avaient	had
fait	fact
mener	lead
les	the
dursley	dursley
veille	eve
rentrée	back to school
mrs	mrs
weasley	weasley
fit	fit
apparaître	appear
par	by
magie	magic
un	a
somptueux	sumptuous
dîner	dinner
qui	that
comportait	included
plats	dishes
préférés	favorite
ainsi	as well
qu'un	a
délicieux	delicious
gâteau	cake
crème	cream
pour	for
terminer	finish
soirée	evening
beauté	beauty
fred	fred
et	and
george	george
firent	did
exploser	explode
pétards	firecrackers
du	the
dr	dr
flibuste	flibuste
véritable	true
feu	fire
d'artifice	fireworks
remplissant	filling
cuisine	kitchen
d'étoiles	star
rouges	red
bleues	blue
rebondirent	rebondirent
sur	on
murs	walls
plafond	ceiling
pendant	during
bonne	good
demi-heure	a half-hour
ils	they
burent	drank
ensuite	then
dernière	last
tasse	cup
chocolat	chocolate
avant	before
d'aller	go
se	is
coucher	bedroom
lendemain	next day
matin	morning
mirent	started
longtemps	for a long time
préparer	prepare
s'étaient	had
tous	all
levés	surveys
chant	song
coq	cock
encore	yet
beaucoup	a lot
faire	do
tout	all
monde	world
s'activait	sped
dans	in
maison	home
moitié	half
habillé	dressed
morceau	song
toast	toast
main	hand
criant	screaming
bougonnant	bougonnant
sans	without
cesse	stops
mr	mr
faillit	almost
même	even
rompre	break
cou	neck
trébuchant	stumbling
contre	against
poulet	chicken
alors	then
traversait	crossed
cour	court
mettre	put
valise	suitcase
ginny	ginny
voiture	car
voyait	saw
pas	not
comment	how
huit	eight
personnes	people
six	six
grosses	large
valises	suitcases
deux	two
hiboux	owls
rat	rat
allaient	would
pouvoir	power
tenir	take
petite	small
ford	ford
anglia	anglia
c'était	it was
compter	from
aménagements	amenities
très	very
particuliers	individuals
apportés	made
mot	word
molly	molly
surtout	especially
chuchota-t-il	whispered-t-he
l'oreille	the ear
ouvrant	opening
coffre	safety deposit box
quelques	a few
tours	towers
permis	permit
d'agrandir	to enlarge
suffisamment	enough
y	there
ranger	ranger
toutes	all
prirent	took
place	place
siège	seat
taille	size
d'un	a
banc	bench
public	public
tandis	while
banquette	bench
arrière	rear
offrait	offered
d'espace	space
percy	percy
s'y	there
asseoir	sit
confortablement	comfortably
finalement	finally
moldus	muggle
sont	are
astucieux	clever
qu'on	we
pense	think
vous	you
trouvez	find
remarqua	noticed
quand	when
on	it
voit	see
cette	this
l'extérieur	outside
dirait	looks like
jamais	never
a	has
autant	as much
l'intérieur	inside
mit	mit
moteur	engine
marche	walking
traversa	crossed
cahotant	several
avec	with
pincement	pinch
cœur	heart
retourna	returned
regarder	watch
fois	time
préparatifs	preparations
mis	put
temps	time
prévu	expected
après	after
avoir	have
jeté	cast
coup	blow
d'œil	eye
montre	watch
tourna	turned
vers	to
femme	woman
ma	my
chérie	sweetheart
je	I
crois	believe
nous	we
irions	go
si	if
non	not
arthur	arthur
répliqua	replied
personne	person
verrait	would
petit	small
bouton	button
tu	you
vois	see
là	there
commande	command
réacteur	reactor
d'invisibilité	invisibility
j'ai	I
installé	installed
pourrions	could
décoller	take off
instantanément	instantly
voler	fly
au-dessus	above
nuages	clouds
dix	ten
minutes	minutes
serions	would be
arrivés	arrived
s'aperçoive	notices
dit	said
plein	full
jour	day
arrivèrent	arrived
devant	before
king's	king's
cross	cross
onze	eleven
heures	hours
moins	less
quart	quarter
précipita	rushed
aller	go
chercher	search
chariots	carts
bagages	luggage
s'engouffrèrent	if engouffrèrent
grands	great
gare	station
déjà	already
pris	taken
express	express
l'année	the year
précédente	previous
difficulté	difficulty
consistait	was
trouver	find
voie	way
9	9
3/4	3/4
n'était	there was
visible	visible
aux	the
yeux	eyes
accéder	access
fallait	had to
traverser	cross
barrière	barrier
dressait	was
entre	between
voies	pathways
10	10
indolore	painless
devait	should
attention	attention
remarquent	notice
rien	nothing
vas-y	vas-y
premier	first
front	front
soucieux	anxious
voyant	light
grosse	big
pendule	pendulum
leur	their
restait	remained
cinq	five
franchir	cross
comme	as
s'avança	advanced
décidé	decided
disparut	disappeared
suivirent	followed
j'y	I
vais	'll
passez	go
suite	suite
elle	it
attrapa	caught
fonça	rushed
clin	clin
également	also
disparu	gone
viens	just
va	will
ensemble	all
reste	rest
peine	penalty
minute	minute
s'assura	secured
cage	cage
d'hedwige	of hedwig
solidement	securely
calée	savvy
tourner	turn
chariot	cart
face	in the face of
parfaitement	perfectly
difficile	difficult
prendre	take
poudre	powder
cheminette	cheminette
penchés	looked
leurs	their
s'avancèrent	advanced
côte	coast
marchant	walking
lorsqu'ils	when they
furent	were
qu'à	as
mètre	meter
courir	run
shplÂÂaaannnggg	shplÂÂaaannnggg
heurtèrent	smote
fouet	whip
choc	shock
rebondir	bounce
tomba	fell
grand	great
bruit	noise
vol	flight
plané	glide
roula	roula
sol	soil
vacarme	din
hululements	hululements
indignés	indignant
regards	looks
tournèrent	turned
eux	them
vigile	vigil
hurlant	screaming
qu'est-ce	what is this
fabriquez	make
perdu	lost
contrôle	control
mon	my
répondit	replied
releva	rose
péniblement	painfully
frottant	rubbing
ses	its
côtes	coast
endolories	sore
courut	ran
ramasser	pick up
poussait	pushing
tels	such
hurlements	howling
certains	some
voyageurs	travelers
commençaient	started
marmonner	mumble
commentaires	comments
mauvais	bad
traitements	treatments
infligés	inflicted
animaux	animals
ça	it
n'ait	did
réussi	successful
passer	pass
chuchota	whispered
j'en	I
sais	know
lança	launched
inquiets	worried
autour	around
douzaine	dozen
continuaient	continued
observer	observe
rater	miss
train	train
murmura	whispered
comprends	understand
vraiment	really
pourquoi	why
passage	passage
est	is
resté	stayed
fermé	closed
l'estomac	the stomach
contracté	contracted
leva	rose
l'horloge	the clock
géante	giant
secondes	seconds
neuf	nine
précaution	caution
amena	brought
son	its
jusqu'à	up to
puis	then
poussa	pushed
forces	forces
métal	metal
infranchissable	impassable
trois	three
seconde	second
Ça	It
parti	party
consterné	appalled
mes	my
parents	parents
peuvent	can
repasser	iron
l'autre	the other
sens	meaning
as	as
l'argent	the money
eut	had
rire	laugh
amer	bitter
peu	little
près	near
ans	years
m'ont	I have
donné	given
d'argent	money
poche	pocket
dit-il	he said
colla	colla
glacé	glossy
n'entends	do not hear
d'une	a
voix	voice
tendue	tense
peut	can
me	me
demande	request
combien	how
faudra	will
venir	come
retrouver	find
regardèrent	looked
d'eux	of them
badauds	onlookers
attirés	attracted
cris	cree
stridents	strident
vaut	worth
mieux	better
aille	go
attendre	wait
remarquer	notice
ici	here
s'exclama	exclaimed
regard	look
soudain	suddenly
brillant	brilliant
quoi	what
croyais	thought
coincés	stuck
faut	must
trouve	find
moyen	average
l'école	the school
or	gold
sorciers	wizards
cycle	cycle
ont	have
droit	right
usage	use
cas	case
d'urgence	emergency
chapitre	chapter
dix-	ten-
code	code
restriction	restriction
sentit	felt
brusquement	suddenly
panique	panic
l'excitation	the excitement
saurais	would
aucun	no
problème	problem
assura	assura
tournant	turning
sortie	output
allons-y	let's go
dépêche	hurry
pourra	may
rattraper	catch up
suivre	follow
s'élancèrent	started
travers	through
hall	hall
fendant	splitting
foule	crowd
intrigués	intrigued
eurent	had
rejoint	joined
l'anglia	the anglia
ouvrit	opened
gigantesque	gigantic
tapotant	tapping
carrosserie	body
baguette	wand
magique	magic
rangèrent	them
posèrent	laid
s'installèrent	settled
l'avant	the front
vérifie	checks
regarde	look at
faisant	making
démarrer	start
autre	other
circulation	traffic
l'avenue	the avenue
loin	far
rue	street
laquelle	which
trouvait	was
déserte	deserted
peux	can
appuya	supported
argenté	silver
aménagé	arranged
tableau	table
bord	edge
aussitôt	as soon
aussi	also
sentait	felt
vibrer	vibrate
sous	under
entendait	heard
mains	hands
genoux	knees
lunettes	glasses
nez	nose
ce	this
sinistre	disaster
s'éloignait	depart
au-dessous	below
invisible	invisible
s'élevait	was
airs	air
gaz	gas
immeubles	buildings
alentour	around
sortirent	went out
champ	field
vision	vision
bientôt	soon
virent	saw
toute	any
ville	city
londres	london
s'étaler	spread
baignée	bathed
brume	mist
lumières	lights
réapparut	reappeared
oh	oh
appuyant	pressing
ratés	misfire
marteler	hammer
s'il	if it
faux	false
contact	contact
tiens-toi	stand
cria	cried
écrasa	crushed
l'accélérateur	the accelerator
bas	the bottom
s'étiraient	stretched
plongèrent	dove
brouillard	fog
grisâtre	greyish
maintenant	now
regardant	looking at
masse	mass
compacte	compact
enveloppait	enveloped
repère	cue
savoir	know
quelle	what
direction	management
redescends	'm going down
repassèrent	repassèrent
couche	layer
tordirent	tordirent
juste	just
là-bas	there
filait	spinning
serpent	snake
écarlate	scarlet
nord	north
jetant	throwing
boussole	compass
suffira	suffice
vérifier	check
demi-heures	half-hours
remonta	came up
flèche	arrow
traversant	crossing
soleil	sun
avions	aircraft
échangèrent	exchanged
éclatèrent	burst
long	long
fut	was
impossible	impossible
sérieux	serious
imaginer	imagine
meilleure	best
façon	how
voyager	travel
songea	songea
voir	see
défiler	scroll
tourbillons	swirls
formes	forms
extraordinaires	extraordinary
restant	remaining
chaud	hot
éclatant	bright
caramels	caramel
boîte	box
gants	gloves
joie	joy
contempler	contemplate
l'expression	the expression
envieuse	jealous
feraient	would
atterrissage	landing
spectaculaire	spectacular
vaste	wide
pelouse	lawn
régulièrement	regularly
descendaient	down
toujours	always
vue	view
présent	this
paysage	landscape
changeait	changed
verdure	green
prés	meadows
laissé	left
landes	landes
couleurs	colors
pourpres	purple
apercevait	caught sight of
tour	tour
villages	villages
minuscules	tiny
églises	churches
villes	cities
grandes	large
sillonnées	grooved
voitures	cars
ressemblaient	looked like
insectes	insects
multicolores	multi-coloured
sept	seven
tard	later
cependant	however
dut	otc
s'avouer	admit
paraissait	seemed
soif	thirst
n'avaient	had
boire	drink
faisait	was
sueur	sweat
glissaient	slide
bout	end
forme	form
devenue	become
indifférente	indifferent
songeait	was thinking of
envie	want
jus	juice
citrouille	pumpkin
frais	fees
servait	served
donc	so
n'avaient-ils	had they
pu	could
doit	must
être	be
enrouée	hoarse
descendait	down
baignant	bathing
lueur	glow
rosé	rosé
jeter	throw
prêt	loan
l'express	the express
serpentant	winding
montagnes	mountains
sommets	summits
enneigés	snowy
sombre	dark
enfonça	stuck
reprit	took
l'altitude	the altitude
commença	started
peiner	toil
émettant	emitting
sorte	so
plainte	complaint
inquiet	worried
fatiguée	tired
n'a	did
parcouru	traveled
longue	long
distance	distance
semblant	pretend
devenait	became
intense	intense
ciel	sky
s'assombrissait	darkened
étoiles	star
éclore	hatch
l'obscurité	the dark
approche	approach
parlait	spoke
n'y	there
tapota	tapped
geste	gesture
nerveux	nervous
redescendirent	climbed back down
scrutèrent	peered
essayer	try
repérer	identify
endroit	place
familier	familiar
s'écria	cried
sursauter	jump
hedwige	hedwig
découpant	cutting
pénombre	penumbra
l'horizon	the horizon
nombreuses	many
château	castle
dressaient	up
sommet	summit
falaise	cliff
dominait	dominated
lac	lake
s'était	had
mise	update
parts	units
perdait	lost
vitesse	speed
allons	will
arrive	happens
ton	your
cajoleur	cajoleur
donnant	giving
volant	steering wheel
secousse	shake
grogna	" 
petits	small
jets	jets
vapeur	steam
capot	hood
machinalement	going through the motions
cramponna	cramponna
bords	edges
oscilla	wavered
dangereusement	dangerously
vitre	glass
surface	surface
noire	black
lisse	smooth
luisante	shiny
s'étendait	extended
centaines	hundreds
mètres	meters
crispées	tense
nouveau	new
calme	quiet
étaient	were
ferraille	scrap
tousser	cough
s'arrêta	stopped
complètement	completely
terrible	terrible
silence	silence
régnait	reigned
piqua	piqua
tombaient	fell
fonçant	darkening
muraille	wall
noooooon	noooooon
hurla	screamed
désespérément	desperately
décrivit	described
grande	great
courbe	curve
évita	evita
mur	wall
d'extrême	extreme
justesse	accuracy
poursuivit	continued
au-	at-
dessus	top
serres	greenhouses
potager	vegetable garden
perdant	loser
d'altitude	altitude
lâcha	released
sortit	went out
stop	stop
hurla-t-il	"he yelled,
donna	donna
coups	shots
pare-brise	windshield
descente	descent
inexorable	inexorable
rapprochait	close
À	To
l'arbre	the tree
plongea	dove
booooooÏÏÏÏÏnnnnng	booooooÏÏÏÏÏnnnnng
assourdissant	deafening
tôle	sheet
s'écrasant	crashing
l'énorme	the huge
tronc	trunk
percuta	collided
lourdement	heavily
panache	plume
accordéon	accordion
terreur	terror
bosse	kicker
balle	ball
golf	golf
apparut	appeared
l'endroit	the place
où	where
heurté	hit
laissa	let
échapper	escape
déchirante	heartbreaking
demanda	asked
précipitamment	hurriedly
tremblante	trembling
presque	almost
cassée	broken
extrémité	end
pendait	hung
lamentablement	miserably
retenue	withholding
fibres	fibers
bois	wood
bouche	mouth
dire	say
quelqu'un	someone
pourrait	could
sûrement	surely
réparer	repair
n'eut	had
prononcer	pronounce
moindre	less
quelque	some
chose	thing
frappa	hit
flanc	flank
force	force
taureau	bull
pleine	full
charge	load
projeta	projected
toit	roof
passe	pass
hoquet	hiccup
fixé	set
vit	lives
branche	branch
l'épaisseur	the thickness
gros	wholesale
python	python
s'abattre	down
lequel	which
écrasés	crushed
attaquer	attack
penché	leaning
branches	branches
noueuses	knotty
martelaient	martelaient
férocement	fiercely
aaaaaaaarrrrggghhh	aaaaaaaarrrrggghhh
qu'une	a
enfonçait	sinking
violemment	violently
portière	door
rameaux	branches
déchaînés	raging
faisaient	were
trembler	shake
énorme	huge
tambourinait	drummed
commençait	started
creuser	dig
sauve	saves
pesant	weighing
poids	weight
vigoureux	vigorous
uppercut	uppercut
fichus	damn
marmonna-t-il	mumbled to himself he
s'enfonçait	sinking
plancher	floor
remis	given
recula	backed
calma	calma
l'entendirent	heard it
craquer	crack
essayait	tried
déraciner	uproot
poursuivre	continue
continuant	continuing
donner	give
hors	out
portée	scope
haletant	panting
bravo	bravo
portes	doors
s'ouvrirent	opened
grincement	grinding
basculé	switched
atterrissant	landing
plat	flat
ventre	belly
bras	arm
croix	cross
humide	wet
sourd	deaf
éjecta	éjecta
projetée	projected
au-dehors	outside
terre	earth
s'ouvrant	opening
chouette	owl
s'envola	flew
cri	cry
colère	anger
fila	fila
tire-d'aile	tire-wing
lacérée	lacerated
cabossée	dented
fumante	steaming
s'éloigna	walked away
ténèbres	darkness
feux	lights
rougeoyant	glowing
fureur	fury
reviens	come back
papa	dad
tuer	kill
t'en	you
vas	vas
brandissant	waving
pétarade	popping
pot	pot
d'échappement	exhaust
parles	talk
chance	chance
consternée	appalled
penchant	leaning
croûtard	croûtard
parmi	among
arbres	trees
parc	park
choisi	chosen
s'écraser	crashing
celui	the
rend	makes
jeta	threw
vieil	old
arbre	tree
continuait	continued
d'agiter	shake
air	air
menaçant	threatening
las	las
ferait	would
rentrer	return
l'arrivée	the arrival
triomphante	triumphant
qu'ils	they
imaginée	imagined
meurtris	bruised
tremblants	trembling
froid	cold
saisirent	seized
poignée	handle
traînèrent	dragged
derrière	behind
montait	rose
pente	slope
douce	soft
l'imposant	the imposing
portail	portal
chêne	oak
banquet	banquet
dû	due
commencer	start
laissant	leaving
tomber	fall
pied	foot
marches	steps
menaient	led
l'entrée	the entry
s'approcha	approached
silencieusement	silently
fenêtre	window
éclairée	lit
regarda	looked at
hé	hey
cérémonie	ceremony
répartition	distribution
rejoignit	joined
observèrent	watched
passait	passed
salle	room
d'innombrables	countless
chandelles	candles
flottaient	floating
quatre	four
tables	tables
desquelles	which
élèves	students
assis	sitting
assiettes	plates
gobelets	cups
d'or	gold
étincelants	sparkling
reconstituait	restored
illuminé	illuminated
forêt	forest
chapeaux	hats
pointus	sharp
remplissait	filled
distingua	distinguished
rangée	row
d'élèves	students
première	first
année	year
attendaient	waiting
visage	face
anxieux	anxiety
facilement	easily
repérable	tracked
grâce	thanks
cheveux	hair
roux	roux
vif	bright
typiques	typical
famille	family
professeur	professor
mcgonagall	mcgonagall
sorcière	witch
chignon	bun
posait	was
célèbre	famous
choixpeau	sorting hat
tabouret	stool
chaque	each
vieux	old
chapeau	hat
malpropre	messy
effiloché	frayed
rapiécé	patched
répartissait	distributed
nouveaux	new
arrivants	arrivals
différentes	different
maisons	houses
regroupaient	included
selon	according to
caractère	character
aptitudes	skills
(les	(the
gryffondor	gryffindor
poufsouffle	hufflepuff
serdaigle	ravenclaw
serpentard)	slytherin)
rappelait	reminded
lui-même	himself
coiffé	wearing
an	year
auparavant	previously
pétrifié	petrified
attendu	expected
décision	decision
murmurée	whispered
instants	moments
terrifiants	terrifying
craint	fears
l'envoie	sends
chez	in
serpentard	slytherin
d'où	where
sortis	out
nombre	number
adeptes	followers
choix	choice
porté	worn
retrouvé	found
hermione	hermione
autres	other
dernier	last
trimestre	quarter
aidé	helped
remporter	win
coupe	cup
battant	flying
depuis	since
garçon	boy
clairs	clear
venait	came
d'être	to be
appelé	called
tête	head
aperçut	saw
dumbledore	dumbledore
directeur	director
assistait	attended
table	table
professeurs	teachers
barbe	beard
argentée	silver
demi-lune	half-moon
luisaient	shiny
lumière	light
reconnut	recognized
gilderoy	gilderoy
lockhart	lockhart
vêtu	dressed
robe	dress
sorcier	sorcerer
bleu-vert	blue-green
hagrid	hagrid
immense	huge
hirsute	shaggy
vidait	emptied
contenu	content
gobelet	cup
dis-donc	say-so
chaise	chair
vide	empty
profs	teachers
rogue	rogue
severus	severus
aimait	loved
l'élève	the student
détestait	hated
cruel	cruel
sarcastique	sarcastic
honni	hated
sauf	except
propre	own
potions	potions
magiques	magic
peut-être	maybe
malade	sick
d'espoir	hope
ou	or
fini	finished
démissionner	resign
suggéra	suggested
parce	because
confié	entrusted
cours	during
défense	defence
mal	evil
été	been
renvoyé	returned
enthousiasme	enthusiasm
déteste	hate
attend	waiting
n'êtes	there are
venus	come
glacée	ice
volte-face	volte-face
agitée	rough
brise	breeze
tenait	held
mince	thin
teint	complexion
jaunâtre	yellowish
crochu	hooked
graisseux	fat
épaules	shoulders
sourire	smile
arborait	sported
cet	this
instant	now
signifiait	meant
clairement	clearly
ennuis	trouble
suivez-moi	follow me
oser	dare
échanger	exchange
montèrent	went up
d'entrée	input
éclairé	informed
torches	torches
délicieuse	delicious
odeur	smell
parvenait	could
emmena	took
opposée	opposite
descendre	down
l'escalier	the stairs
menait	led
sous-sols	sub-soil
entrez	enter
ordonna-t-il	he ordered
porte	door
milieu	middle
l'étroit	the narrow
couloir	hallway
tremblant	tremblant
membres	members
pénétrèrent	penetrated
bureau	office
sombres	dark
recouverts	covered
d'étagères	shelves
remplies	true
bocaux	jars
verre	glass
lesquels	which
choses	things
répugnantes	disgusting
dont	which
voulait	wanted
connaître	know
nom	name
cheminée	fireplace
refermé	closed
élever	raise
n'est	there is
assez	enough
potter	potter
fidèle	faithful
préférait	preferred
arrivée	arrival
fasse	do
n'est-ce	is this
monsieur	mr.
c'est	it is
coupa	cut
qu'avez-vous	what have you
avala	swallowed
donnait	gave
l'impression	printing
lire	read
pensées	thoughts
déroula	took place
numéro	number
soir	evening
vus	seen
siffla-t-il	whistle-t-he
montrant	showing
titre	title
s'étalait	spread
volante	flying
inquiÈte	concerned
l'article	article
haute	high
londoniens	london
affirment	say
vu	seen
vieille	old
poste	post
centrale	central
midi	midi
comté	county
norfolk	norfolk
hetty	hetty
bayliss	bayliss
suspendait	suspended
lessive	laundry
jardin	garden
angus	angus
fleet	fleet
peebles	peebles
déclaré	said
police	police
résuma	summed up
votre	your
père	father
travaille	works
service	service
détournements	diversions
l'artisanat	crafts
moldu	muggle
cela	this
ajouta-t-il	he added
adressant	sending
féroce	fierce
dieu	god
fils	son
d'avoir	to have
reçu	received
creux	hollow
fou	crazy
découvrait	discovered
ensorcelé	bewitched
n'avait	had
pensé	thought
recherches	research
constaté	found
valeur	value
inestimable	priceless
subi	suffered
dommages	damage
considérables	considerable
subir	undergo
protesta	protested
malheureusement	unfortunately
n'appartenez	not belong
m'appartient	belongs to me
décider	decide
exclusion	exclusion
disposent	have
attendez-moi	wait for me
livide	livid
faim	hunger
nausée	nausea
allé	gone
directrice	director
n'allaient	not going to
s'arranger	arrange
montrerait	show
injuste	unfair
sévère	severe
retour	return
l'accompagnait	accompanied
eu	had
l'occasion	the opportunity
plusieurs	several
reprises	times
point-là	point
dès	as soon
qu'elle	it
entrée	entry
brandit	holds up
recroquevillèrent	recroquevillèrent
contenta	contenta
pointer	point
ronflant	snoring
ordonna-t-elle	ordered it
reprirent	resumed
chaises	chairs
auprès	with
explications	explanations
ajouta-t-elle	"she added,
étincelantes	sparkling
menaces	threats
récit	story
aventure	adventure
commençant	starting
refusé	refused
laisser	let
n'avions	did
monter	mount
avez-vous	have you
envoyé	sent
lettre	letter
hibou	owl
aviez	had
j'imagine	I guess
sèchement	curtly
bée	eer
disait	said
semblait	seemed
évidente	obvious
n'ai	haven
paru	published
alla	alla
ouvrir	open
corps	body
s'engourdir	numb
solennel	solemn
coutumier	customary
baissa	lowered
regretta	regret
n'être	not to be
recevoir	receive
pourriez-vous	could you
m'expliquer	explain to me
avez	have
aurait	would
valu	earned
mette	mette
hurler	scream
d'entendre	to hear
nuance	nuance
déception	disappointment
incapable	unable
contemplant	contemplating
avoua	admitted
propriétaire	owner
ensorcelée	bewitched
l'en	the
croire	believe
trouvé	found
hasard	random
garée	parked
proximité	close
savait	knew
serait	would be
dupe	dupe
posa	posa
aucune	no
question	question
concernant	on
lorsque	when
terminé	finished
nos	our
affaires	business
désespéré	desperate
bref	brief
aujourd'hui	today
dois	do
insister	insist
gravité	gravity
j'écrirai	I will write
vos	your
familles	families
avertir	warn
prochaine	next
sottise	stupidity
genre	kind
n'aurai	will not
d'autre	on the other
renvoyer	return
n'aurait	would
semblé	seemed
déçu	disappointed
l'avait	had
privé	private
noël	christmas
s'éclaircissant	thins
gorge	throat
ces	these
jeunes	young
gens	people
n'ont	have
tenu	view
compte	account
décret	decree
l'usage	the use
infligé	inflicted
doute	doubt
actes	acts
nature	nature
appartiendra	will be
punition	punishment
méritent	deserve
paisible	peaceful
font	do
partie	part
placés	placed
responsabilité	responsibility
reprendre	resume
minerva	minerva
instructions	instructions
venez	come
tarte	pie
j'aimerais	I would like to
goûter	taste
venimeux	venomous
seuls	only
observait	watched
d'aigle	eagle
furieux	furious
feriez	would
l'infirmerie	the infirmary
dit-elle	she said
saignez	bleeding
essuyant	wiping
revers	reverse
manche	sleeve
coupure	cut
l'œil	the eye
sœur	sister
envoyée	sent
terminée	complete
ah	ah
parlant	speaking
l'interrompit	the interrupted
avons	have
emprunté	borrowed
commencé	started
devrions	should
points	points
pénalité	penalty
perçant	piercing
juré	juror
souri	smiled
n'enlèverai	do not remove
soulagement	relief
aurez	will
chacun	each
pointa	pointa
rempli	filled
sandwiches	sandwiches
pichet	pitcher
allez	go
filerez	speed through
directement	directly
dortoir	dormitory
refermée	closed
sifflement	whistle
cru	raw
attrapant	catching
sandwich	sandwich
moi	me
prit	took
demi-douzaine	a half-dozen
haussa	hausa
intérêt	interest
partir	from
j'aurais	I would have
aimé	loved
participer	participate
pavaner	strutting
arriver	getting
notre	our
succès	success
mangé	ate
purent	could
avaler	swallow
renouvelaient	new ones kept on coming
mesure	measurement
mangeaient)	ate)
quittèrent	left
dirigèrent	headed
silencieux	silent
apparemment	apparently
chemin	path
portraits	portraits
chuchotèrent	whispered
armures	armor
grincer	squeak
étroit	close
escalier	staircase
pierre	stone
retrouvèrent	found
caché	hidden
l'accès	access
commune	common
dortoirs	dormitories
toile	canvas
représentait	represented
vêtue	dressed
portrait	portrait
approcher	approach
heu	uh
balbutia	stammered
connaissaient	knew
début	beginning
d'année	of the year
entendirent	heard
pressés	in a hurry
granger	granger
voilà	this is
s'exclama-t-elle	exclaimed she
étiez-vous	were you
passés	past
ridicules	ridiculous
sujet	about
paraît	seems
renvoyés	returned
accident	accident
laisse	leaves
leçons	lessons
morale	moral
impatience	impatience
donne-nous	give us
anthochère	anthochère
voulais	wanted
parler	talk
interrompue	interrupted
dame	lady
pivota	swung
libérer	free
s'éleva	rose
tonnerre	thunder
d'applaudissements	applause
dormait	slept
rassemblés	gathered
circulaire	circular
tenaient	held
debout	standing
bancales	dangling
fauteuils	chairs
défoncés	stoned
tendirent	craned
happer	snatch
qu'hermione	as hermione
suivait	followed
tant	as
lee	lee
jordan	jordan
belle	beautiful
imagination	imagination
parlera	talk
félicitations	congratulations
élève	student
cinquième	fifth
tape	tape
amicale	friendly
l'épaule	the shoulder
marathon	marathon
frayèrent	advanced
auriez	would
appeler	call
vienne	vienna
dirent-ils	they said
souriait	smiling
gêné	embarrassed
l'air	the air
partager	share
l'allégresse	the joy
générale	general
dépassant	exceeding
s'avancer	advance
exprimer	express
désapprobation	disapproval
convenait	should
rôle	role
préfet	prefect
coude	elbow
frère	brother
signe	sign
comprit	understood
vaudrait	would
monte	monte
fatigués	tired
fendirent	people
côté	side
nuit	night
réprobateur	réprobateur
dépêchèrent	dispatched
poussèrent	pushed
pièce	room
lits	beds
baldaquins	canopies
tendus	tense
velours	velvet
rouge	red
hautes	high
fenêtres	windows
étroites	narrow
apportées	made
coupable	guilty
devrait	should
fiers	proud
s'ouvrit	opened
volée	fly
livra	delivered
camarades	comrades
classe	class
seamus	seamus
finnigan	finnigan
dean	dean
thomas	thomas
neville	neville
londubat	londubat
incroyable	amazing
rayonnant	radiant
cool	cool
etonnant	amazing
éperdu	distraught
d'admiration	admiration
put	put
