9	9
l'avertissement	the warning
qu'est-ce	what is this
qui	that
se	is
passe	pass
ici	here
attiré	attracted
par	by
les	the
cris	cree
de	of
malefoy	malfoy
argus	argus
rusard	rusard
fraya	fraya
un	a
chemin	path
dans	in
la	the
foule	crowd
des	of
élèves	students
lorsqu'il	when it
vit	lives
miss	miss
teigne	ringworm
il	it
recula	backed
horrifié	horrified
en	in
couvrant	covering
le	the
visage	face
ses	its
mains	hands
ma	my
chatte	pussy
est	is
arrivé	arrived
à	to
hurla-t-il	"he yelled,
yeux	eyes
exorbités	bulging
posèrent	laid
alors	then
sur	on
harry	harry
vous	you
cria-t-il	he shouted
d'une	a
voix	voice
stridente	shrill
c'est	it is
avez	have
assassiné	murdered
l'avez	have
tuée	killed
et	and
maintenant	now
moi	me
vais	'll
tuer	kill
je	I
dumbledore	dumbledore
venait	came
d'arriver	to arrive
couloir	hallway
suivi	follow-up
plusieurs	several
professeurs	teachers
instant	now
plus	more
tard	later
avait	had
détaché	detached
torchère	flare
venez	come
avec	with
dit-il	he said
aussi	also
mr	mr
potter	potter
weasley	weasley
granger	granger
lockhart	lockhart
s'avança	advanced
d'un	a
air	air
empressé	quick
mon	my
bureau	office
juste	just
côté	side
monsieur	mr.
directeur	director
si	if
souhaitez	want to
l'utiliser	the use
merci	thank you
gilderoy	gilderoy
dit	said
silencieux	silent
s'écartèrent	if parted
pour	for
laisser	let
passer	pass
emboîta	emboîta
pas	not
mcgonagall	mcgonagall
rogue	rogue
lorsqu'ils	when they
furent	were
entrés	entered
étendit	extended
table	table
commença	started
l'examiner	the review
ron	ron
hermione	hermione
échangèrent	exchanged
regards	looks
inquiets	worried
laissèrent	left
tomber	fall
chaises	chairs
coin	corner
sombre	dark
pièce	room
ausculta	circled
soigneusement	carefully
sous	under
regard	look
attentif	attentive
du	the
professeur	professor
silhouette	silhouette
dessinait	drew
derrière	behind
eux	them
pénombre	penumbra
une	a
expression	expression
bizarre	weird
son	its
comme	as
s'il	if it
s'efforçait	tried
ne	do
sourire	smile
lui	him
papillonnait	papillonnait
autour	around
d'eux	of them
faisant	making
toutes	all
sortes	kinds
commentaires	comments
ponctués	punctuated
sanglots	sobs
affalé	slouching
chaise	chair
concierge	concierge
n'avait	had
courage	courage
regarder	watch
mit	mit
marmonner	mumble
d'étranges	strange
paroles	lyrics
donnant	giving
corps	body
petits	small
coups	shots
sa	its
baguette	wand
magique	magic
mais	but
rien	nothing
produisit	produced
on	it
aurait	would
qu'elle	it
était	was
empaillée	stuffed
enfin	finally
redressa	straightened
elle	it
n'est	there is
morte	dead
douce	soft
s'étrangla	if hanged himself
regardant	looking at
travers	through
doigts	fingers
écartés	apart
comment	how
fait-il	it
soit	either
toute	any
raide	stiff
a	has
été	been
pétrifiée	petrified
bien	well
ce	this
que	that
pensais	thought
commenta	commented
quelle	what
manière	way
voilà	this is
j'ignore	I don't know
reprit	took
qu'il	it
faut	must
demander	ask
hurla	screamed
tournant	turning
vers	to
aucun	no
élève	student
deuxième	second
année	year
n'aurait	would
réussi	successful
faire	do
ça	it
assura	assura
être	be
expert	expert
magie	magic
noire	black
y	there
arriver	getting
insista	insisted
violacé	purple
vu	seen
écrit	written
mur	wall
trouvé	found
sait	knows
suis	am
tordit	twisted
horrible	horrible
grimace	grin
cracmol	cracmol
acheva-t-il	completed-t-he
n'ai	haven
jamais	never
touché	hit
protesta	protested
vigueur	force
sais	know
même	even
qu'est	that is
mensonges	lies
grinça	shrieked
lettre	letter
vitmagic	vitmagic
peux	can
me	me
permettre	allow
intervint	intervened
sentit	felt
inquiet	worried
dirait	looks like
pourrait	could
servir	serve
défense	defence
crois	believe
amis	friends
sont	are
simplement	simply
trouvés	found
au	the
mauvais	bad
endroit	place
moment	time
narquois	mocking
doutait	doubted
propres	own
vrai	true
quoi	what
nourrir	feed
soupçons	suspicions
faisaient-ils	did they
cette	this
heure-là	time
pourquoi	why
n'assistaient-ils	there were present-they
festin	feast
d'halloween	halloween
leurs	their
camarades	comrades
expliquèrent	explained
qu'ils	they
avaient	had
invités	guests
fête	feast
nick	nick
quasi-sans-	quasi-without-
tête	head
centaines	hundreds
fantômes	ghosts
trouvaient	were
là	there
ils	they
pourront	can
témoigner	witness
nous	we
étions	were
n'avez-vous	have you
rejoint	joined
grande	great
salle	room
lorsque	when
êtes	are
remontés	reassembled
cachots	dungeons
demanda	asked
noir	black
étincelant	sparkling
lueur	glow
chandelles	candles
étiez-vous	were you
tournèrent	turned
parce	because
balbutia	stammered
cœur	heart
battant	flying
tout	all
parier	bet
personne	person
croirait	like
histoire	history
désincarnée	disembodied
seul	only
pouvoir	power
entendre	hear
fatigués	tired
voulions	wanted
aller	go
coucher	bedroom
sans	without
avoir	have
mangé	ate
esquissant	sketching
triomphe	triumph
savais	knew
offraient	offered
satisfaire	meet
l'appétit	the appetite
vivants	living
cours	during
fêtes	holidays
n'avions	did
faim	hunger
espérant	hoping
n'entendrait	hear
bruyante	noisy
protestation	protest
estomac	stomach
malfaisant	evil
s'élargit	widens
semble	seems
vérité	truth
reprit-il	"he said
peut-	can-
serait-il	would it be
inutile	useless
priver	deprive
certains	some
privilèges	privileges
jusqu'à	up to
décide	decides
raconter	tell
s'est	is
véritablement	truly
passé	past
personnellement	personally
pense	think
devrait	should
droit	right
jouer	play
l'équipe	the team
quidditch	quidditch
gryffondor	gryffindor
consente	consent
dire	say
vois	see
vraiment	really
faudrait	should
empêcher	prevent
garçon	boy
severus	severus
sèchement	curtly
n'a	did
assommée	stunned
manche	sleeve
balai	broom
n'y	there
aucune	no
preuve	proof
ait	has
fait	fact
quelque	some
chose	thing
répréhensible	objectionable
inquisiteur	inquisitor
eut	had
l'impression	printing
d'être	to be
observé	observed
aux	the
rayons	ray
x	x
innocent	innocent
tant	as
qu'on	we
prouvé	proven
culpabilité	guilt
ton	your
ferme	farm
l'air	the air
furieux	furious
également	also
j'exige	I require
châtiment	punishment
parviendrons	will
guérir	heal
patient	patient
mrs	mrs
chourave	chourave
procurer	buy
plants	plants
mandragore	mandrake
dès	as soon
auront	will
atteint	reached
leur	their
maturité	maturity
m'en	me
servirai	serve
fabriquer	make
potion	potion
ramènera	back
vie	life
chargerai	will
l'ai	I
fois	time
demande	request
pardon	forgiveness
coupa	cut
maître	master
potions	potions
silence	silence
gêné	embarrassed
pouvez	can
partir	from
sortirent	went out
vite	fast
purent	could
évitant	avoiding
toutefois	however
courir	run
eurent	had
l'étage	the floor
supérieur	higher
pénétrèrent	penetrated
classe	class
vide	empty
refermèrent	slid shut
porte	door
croyez	believe
j'aurais	I would have
dû	due
parler	talk
j'ai	I
entendue	heard
non	not
répondit	replied
moindre	less
hésitation	hesitation
bon	good
signe	sign
chez	in
sorciers	wizards
toi	you
tu	you
moins	less
sûr	course
précipitamment	hurriedly
reconnaître	recognize
d'abord	first
voulait	wanted
graffiti	graffiti
chambre	room
secrets	secrets
ouverte	open
signifie	means
Ça	It
rappelle	remember
vaguement	vaguely
lentement	slowly
jour	day
quelqu'un	someone
m'a	me
raconté	told
propos	about
secrète	secret
poudlard	hogwarts
c'était	it was
peut-être	maybe
bill	bill
qu'un	a
surprise	surprise
réprimer	suppress
ricanement	sneer
drôle	funny
concerne	for
né	born
famille	family
contraire	contrary
naissent	born
familles	families
moldus	muggle
sorte	so
cracmols	cracmols
très	very
rares	rare
étonnant	amazing
essaye	try
d'apprendre	to learn
explique	explains
beaucoup	a lot
choses	things
haine	hate
exemple	example
satisfait	satisfied
aigri	embittered
pendule	pendulum
sonna	rang
part	share
château	castle
minuit	midnight
ferait	would
d'aller	go
avant	before
tombe	falls
nouveau	new
trouver	find
autre	other
prétexte	excuse
punir	punish
pendant	during
jours	days
parla	spoke
faisait	was
cent	cent
l'endroit	the place
où	where
l'avait	had
retrouvée	found
espérait	hoped
coupable	guilty
reviendrait	would
lieux	places
crime	crime
récurer	scouring
détergent	detergent
effacer	delete
message	message
continuait	continued
briller	shine
pierre	stone
autant	as much
d'éclat	flash
qu'au	that
premier	first
ginny	ginny
semblait	seemed
perturbée	disturbed
sort	fate
qu'avait	that was
subi	suffered
d'après	after
passion	passion
chats	cats
connaissais	knew
vivement	strongly
franchement	frankly
mieux	better
lèvres	lips
tremblaient	the trembling
rare	rare
arrive	happens
pareilles	such
finiront	will
sûrement	surely
attraper	catch
cinglé	crazy
sera	will be
renvoyé	returned
sur-le-champ	on-the-field
j'espère	I hope
aura	will
temps	time
pétrifier	petrify
mettre	put
dehors	outside
plaisantais	was joking
ajouta	added
aussitôt	as soon
voyant	light
devenir	become
livide	livid
l'agression	aggression
contre	against
eu	had
effet	effect
lecture	reading
toujours	always
occupations	occupations
favorites	favorite
présent	this
d'autre	on the other
plonger	dive
livres	books
demandaient	asked
fabriquait	manufactured
n'obtenaient	did
réponse	response
fut	was
seulement	only
mercredi	Wednesday
suivant	following
comprirent	understood
après	after
déjeuner	breakfast
rejoignit	joined
bibliothèque	library
croisa	crossed
justin	justin
finch-	finch-
fletchley	fletchley
l'élève	the student
poufsouffle	hufflepuff
dont	which
connaissance	knowledge
botanique	botanical
s'apprêtait	was about
bonjour	hello
fit	fit
volte-face	volte-face
s'enfuit	fled
direction	management
opposée	opposite
trouva	found
fond	background
train	train
devoirs	duties
d'histoire	history
n'as	did
montrant	showing
étagères	shelves
lire	read
tous	all
noël	christmas
raconta	told
finch-fletchley	finch-fletchley
pris	taken
fuite	leak
fais	do
attention	attention
peu	little
bête	beast
te	te
souviens	remember
idioties	baloney
racontées	told
grand	great
émergea	emerged
d'entre	of
deux	two
mauvaise	bad
humeur	mood
disposée	willing
adresser	contact
parole	word
exemplaires	best
l'histoire	the story
ont	have
empruntés	borrowed
dit-elle	she said
s'asseyant	sitting
entre	between
liste	list
d'attente	waiting
semaines	weeks
regrette	regrets
d'avoir	to have
laissé	left
exemplaire	copy
maison	home
tenir	take
valise	suitcase
voulais	wanted
bouquin	book
raison	reason
autres	other
légende	legend
justement	precisely
mordant	biting
lèvre	lip
impossible	impossible
livre	book
cloche	bell
trois	three
rendre	make
ennuyeux	boring
emploi	employment
binns	binns
l'enseignait	taught
fantôme	ghost
l'école	the school
entrait	entered
passant	from
tableau	table
l'unique	the unique
amusant	fun
disait	said
s'était	had
rendu	rendering
compte	account
mort	death
levé	survey
installé	installed
fauteuil	chair
devant	before
feu	fire
cheminée	fireplace
depuis	since
continué	continued
changer	change
habitudes	habits
consulta	consulta
notes	notes
débiter	debit
monotone	monotonous
vieil	old
aspirateur	vacuum cleaner
essoufflé	out of breath
bout	end
demi-heure	a half-hour
monde	world
somnolait	was dozing
moitié	half
leva	rose
soudain	suddenly
main	hand
oui	yes
heu	uh
levant	rising
voulu	wanted
pouviez	could
lança	launched
claironnante	claironnante
réveillèrent	woke
sursaut	startle
sifflante	wheezing
m'occupe	I'm involved
faits	facts
mythes	myths
ou	or
légendes	legends
sont-elles	are they
fondées	based
ahuri	bemused
évidence	obviously
première	first
carrière	career
l'interrompait	interrupts
peut	can
discuter	discuss
lente	slow
parlez	talk
tellement	so
extravagante	extravagant
ridicule	ridiculous
étaient	were
suspendus	suspended
stupéfait	stunned
l'intérêt	the interest
manifestait	manifested
eh	eh
voyons	see
pourrais-je	could I
savez	know
fondé	based
mille	thousand
ans	years
date	date
précise	precise
connue	known
quatre	four
grands	great
mages	the magi
sorcières	witches
l'époque	the time
maisons	houses
portent	bear
noms	names
godric	godric
helga	helga
rowena	rowena
serdaigle	ravenclaw
salazar	salazar
serpentard	slytherin
bâti	built
ensemble	all
hors	out
vue	view
car	because
temps-là	time
gens	people
peuple	people
peur	fear
subissaient	were
terribles	terrible
persécutions	persecution
quelques	a few
années	years
fondateurs	founders
travaillèrent	worked
parfaite	perfect
harmonie	harmony
recherchaient	looking for
jeunes	young
montraient	showed
dons	donations
faisaient	were
venir	come
assurer	ensure
éducation	education
désaccords	disagreements
apparurent	appeared
conflit	conflict
éclata	broke out
montre	watch
sélectif	selective
choix	choice
admis	admitted
pensait	thought
savoir	know
devait	should
réservé	reserved
elles	they
seules	only
prendre	take
d'élèves	students
nés	born
parents	parents
estimait	estimated
pouvait	could
confiance	trust
grave	serious
dispute	dispute
sujet	about
opposa	opposed
finit	ends
quitter	leave
pause	break
vieille	old
tortue	turtle
ridée	wrinkled
sources	sources
historiques	historical
dignes	worthy
foi	faith
ces	these
authentiques	authentic
obscurcis	obscured
hautement	highly
fantaisiste	whimsical
aménagé	arranged
cachée	hidden
connaissaient	knew
l'existence	the existence
ensuite	then
scellé	sealed
l'entrée	the entry
telle	such
puisse	can
l'ouvrir	the open
authentique	authentic
héritier	heir
l'héritier	the heir
d'ouvrir	open
d'utiliser	use
contient	contains
chasser	hunt
ceux	those
seraient	would be
d'étudier	to study
long	long
tut	tut
n'était	there was
accompagnait	accompanied
habituellement	usually
l'assoupissement	the slumber
sentiment	feeling
malaise	discomfort
baignait	bathed
l'atmosphère	the atmosphere
tandis	while
gardait	kept
fixés	set
l'espoir	hope
d'en	to
davantage	more
cela	this
totalement	totally
absurde	absurd
agacé	annoyed
doutez	doubt
fouillée	searched
comble	fills
érudits	scholars
essayer	try
découvrir	discover
prétendue	alleged
conclusion	conclusion
n'existe	there is
qu'une	a
affabulation	fabrication
destinée	for
naïfs	naive
entendez	hear
exactement	exactly
trouverait	would
serait	would be
monstre	monster
obéir	obey
puis	then
l'assurer	ensure the
ni	or
objecta	objected
seamus	seamus
finnigan	finnigan
normal	normal
capable	able
répliqua	replied
excédé	exceeded
directeurs	directors
directrices	guidelines
succédé	succeeded
siècles	centuries
n'ont	have
découvert	discovered
doute	doubt
connaître	know
remarquer	notice
parvati	parvati
patil	patil
sorcier	sorcerer
sert	serves
connaît	knows
partie	part
donc	so
dean	dean
thomas	thomas
assez	enough
suffit	just
répète	repeat
s'agit	is
mythe	myth
l'ombre	the shadow
construit	built
serait-ce	would it be
placard	closet
balais	brushes
secret	secret
stupide	stupid
voulez	want to
allons	will
retourner	return
c'est-à-dire	that is to say,
établis	established
vérifiables	verifiable
minutes	minutes
replongé	back
torpeur	torpor
habituelle	usual
su	su
vieux	old
fou	crazy
complètement	completely
tordu	twisted
frayaient	hailed
grouillant	teeming
déposer	file
sacs	bags
descendre	down
dîner	dinner
j'ignorais	I didn't know
inventé	invented
histoires	stories
sang	blood
pur	pure
payait	paid
refuserais	'd refuse
choixpeau	sorting hat
m'y	me
envoyer	send
repris	taken
serais	would be
rentré	back
approuva	approved
vigoureux	vigorous
resta	remained
sentait	felt
l'estomac	the stomach
noué	knotted
sérieusement	seriously
envisagé	considered
l'envoyer	send
souvenait	remember
hier	yesterday
petite	small
parlé	spoken
l'oreille	the ear
mis	put
chapeau	hat
l'année	the year
précédente	previous
as	as
d'immenses	huge
qualités	qualities
sais-tu	do you know
ta	your
t'aiderait	you would help
singulièrement	singularly
grandeur	size
savait	knew
déjà	already
nombreux	many
adeptes	followers
sortis	out
pensé	thought
forces	forces
répondu	answered
es	es
vaut	worth
t'envoyer	send you
colin	colin
crivey	crivey
apparut	appeared
pressaient	pressed
salut	hi
machinalement	going through the motions
type	type
trop	too
petit	small
résister	resist
marée	tide
l'entraînait	the led
emporté	away
ayant	having
lancer	launch
aiguë	acute
pu	could
copain	buddy
j'imagine	I guess
rappelant	recalling
façon	how
enfui	away
croient	believe
n'importe	any
dégoûté	disgusted
s'éclaircit	clears up
monter	mount
l'escalier	the stairs
difficulté	difficulty
existe	there is
répondit-elle	she replied
sourcils	eyebrows
froncés	a frown
penser	think
attaquée	attacked
disons	let's say
d'humain	human
bientôt	soon
retrouvèrent	found
produite	produced
jetèrent	cast
coup	blow
d'oeil	eye
état	state
sauf	except
décrochée	unhooked
posée	asked
lequel	which
lettres	letters
brillantes	brilliant
visible	visible
monte	monte
garde	guard
marmonna	muttered
désert	desert
risque	risk
examiner	review
près	near
posa	posa
sac	bag
pattes	legs
recherche	search
d'indices	indices
traces	traces
brûlure	burn
regarde	look at
releva	rose
dirigea	led
fenêtre	window
montrait	showed
vitre	glass
haut	top
vingtaine	twenty
d'araignées	spiders
prises	taken
panique	panic
battaient	fighting
fente	slot
carreau	tile
fil	wire
d'argent	money
pendait	hung
corde	rope
montées	mounted
hâte	looking forward
fuir	flee
au-dehors	outside
araignées	spiders
agir	act
songeuse	pensive
admit	admitted
jeta	threw
d'œil	eye
par-dessus	above
épaule	shoulder
tenait	held
arrière	rear
efforts	efforts
s'enfuir	escape
jambes	legs
n'aime	likes
tendue	tense
s'étonna	was surprised
pourtant	yet
sers	sers
souvent	often
quand	when
mortes	dead
va	will
voir	see
bouger	move
rire	laugh
féroce	fierce
j'avais	I had
fred	fred
changé	changed
ours	bear
peluche	plush
grosse	big
araignée	spider
répugnante	disgusting
font	do
horreur	horror
frissonna	shivered
s'efforça	tried
éclater	burst
estima	estima
préférable	best
conversation	conversation
souvenez	remember
flaque	puddle
d'eau	water
l'autre	the other
soir	evening
d'où	where
l'a	the
essuyée	wiped clean
retrouvé	found
sang-froid	in cold blood
montra	showed
tendit	handed
poignée	handle
interrompit	interrupted
geste	gesture
entrer	enter
toilettes	toilet
filles	girls
s'approchant	approaching
tour	tour
qu'habité	that inhabited
mimi	mimi
geignarde	whiner
jeter	throw
prêter	pay
panneau	panel
service	service
apposé	affixed
ouvrit	opened
entra	entered
c'étaient	it was
sinistres	claims
eût	had
pieds	feet
lavabos	sinks
ébréchés	chipped
s'alignaient	lined
miroir	mirror
cassé	broken
endroits	places
constellé	studded
taches	spots
rouille	rust
carrelage	tile
humide	wet
reflétait	reflected
faible	low
lumière	light
diffusaient	released
bouts	tips
brûlant	burning
bougeoirs	candle holders
portes	doors
bois	wood
cabines	cabins
écaillées	shelled
l'une	one
d'elles	they
retenue	withholding
gond	gond
doigt	finger
taire	shut up
cabine	cabin
ouvrant	opening
l'intérieur	inside
flottait	floated
au-dessus	above
réservoir	tank
chasse	hunting
percer	drill
bouton	button
menton	chin
toilettes-là	toilets-there
soupçonneux	suspicious
sache	know
montrer	show
joli	nice
demande-lui	ask him
remuant	stirring
silencieusement	silently
chuchotes	chuchotes
fixant	fixing
j'aimerais	I would like to
arrête	stop
dos	back
s'exclama	exclaimed
sanglotante	sobbing
sensibilité	sensitivity
veut	wants to
peine	penalty
bonne	good
lamenta	lamented
longue	long
suite	suite
malheurs	woes
vient	comes
gâcher	spoil
n'avais	had
derniers	last
agressée	attacked
parages	area
nuit-là	night
peeves	peeves
m'avait	I had
énervée	upset
revenue	revenue
suicider	suicide
souvenue	remembered
j'étais	I was
acheva	completed
poussa	pushed
sanglot	sob
tragique	tragic
s'éleva	rose
airs	air
plongea	dove
cuvette	bowl
éclaboussant	splashing
restèrent	stayed
bouche	mouth
bée	eer
rapport	report
d'habitude	usually
presque	almost
aujourd'hui	today
haussant	raising
épaules	shoulders
las	las
s'en	in
refermer	close
étouffés	muffled
pleurer	cry
tuyauterie	piping
lorsqu'une	when a
sonore	sound
sursauter	jump
percy	percy
figé	frozen
place	place
s'exclama-t-il	exclaimed,-t-he
jeté	cast
cherche	looking
indices	indices
filez	filez
immédiatement	immediately
s'écria	cried
précipitant	precipitating
rendez	visit
faites	do
revenir	return
dînent	dine
empêcherait	prevent
fougue	passion
chat	cat
convaincue	convinced
allez	go
expulsés	expelled
bouleversée	upset
n'arrêtait	never stopped
pourrais	could
surexcités	excited
arrivée	arrival
penses	think
oreilles	ears
rougissaient	blushed
gâche	waste
tes	your
chances	chances
préfet-en-chef	prefect-in-chief
j'enlève	I take off
cinq	five
points	points
cassant	breaking
insigne	badge
préfet	prefect
astiqué	polished
serve	serve
leçon	lesson
arrêtes	stop
détectives	detectives
j'écris	I write
maman	mom
s'éloigna	walked away
nuque	neck
rouge	red
retour	return
commune	common
soir-là	evening
s'assirent	sat
loin	far
possible	possible
renvoyer	return
enfants	children
mi-voix	mi-voice
poursuivait	continued
venaient	came
semblant	pretend
perplexe	puzzled
moins-que-rien	less-than-nothing
échangea	exchanged
paraissait	seemed
parles	talk
parle	speaks
sang-de-bourbe	blood-of-mire
face	in the face of
rat	rat
comprendre	understand
murmura	whispered
sceptique	skeptical
passés	past
vante	boasts
pourraient	could
descendants	descendants
père	father
possèdent	have
clé	key
doivent	must
fils	son
prudence	caution
prouver	prove
moyen	average
suggéra	suggested
baissant	lowering
difficile	difficult
dangereux	dangerous
violer	violate
cinquantaine	fifty
d'articles	articles
règlement	regulation
mois	months
expliquer	explain
écoutez-moi	listen to me
puissions	can
pénétrer	enter
poser	ask
questions	questions
s'aperçoive	notices
éclatait	broke out
polynectar	polynectar
demandèrent	asked
d'écouter	to listen
grommela	grumbled
permet	allows
l'apparence	the appearance
réfléchissez	think about it
transformer	transform
doit	must
vanter	boast
paraît	seems
louche	ladle
fronçant	frowned
l'effet	the effect
disparaît	disappears
d'obtenir	to obtain
recette	recipe
figurait	was
intitulé	title
pouvoirs	powers
réserve	reserve
n'existait	there was
accès	access
ouvrage	book
présenter	present
autorisation	authorization
écrite	written
croire	believe
besoin	need
s'intéresser	if interested
uniquement	only
théorie	theory
chance	chance
prof	prof
croira	believe
idiot	idiot
