10	10
le	the
cognard	cognard
fou	crazy
depuis	since
désastreux	disastrous
épisode	episode
des	of
lutins	goblins
professeur	professor
lockhart	lockhart
n'avait	had
plus	more
amené	led
de	of
créatures	creatures
vivantes	living
en	in
classe	class
il	it
se	is
contentait	just
lire	read
passages	passages
ses	its
livres	books
à	to
élèves	students
reconstituant	reconstructing
les	the
scènes	scenes
qui	that
mettaient	put
mieux	better
valeur	value
souvent	often
demandait	asked
harry	harry
jouer	play
rôle	role
d'une	a
créature	creature
féroce	fierce
qu'il	it
avait	had
terrassée	down
délivrant	delivering
ainsi	as well
tout	all
un	a
village	village
menace	threat
mortelle	fatal
ce	this
jour-là	day
fit	fit
d'un	a
loup-garou	loup-garou
rendu	rendering
forme	form
humaine	human
mettant	putting
fin	end
la	the
terreur	terror
que	that
monstre	monster
faisait	was
régner	reign
sur	on
paysans	farmers
du	the
coin	corner
lorsque	when
cloche	bell
sonna	rang
pour	for
annoncer	announce
cours	during
rejoignit	joined
ron	ron
et	and
hermione	hermione
au	the
fond	background
prêt	loan
murmura	whispered
allons-y	let's go
dit	said
elle	it
s'approcha	approached
bureau	office
morceau	song
papier	paper
serré	tight
dans	in
sa	its
main	hand
tenaient	held
derrière	behind
heu	uh
balbutia	stammered
j'aurais	I would have
voulu	wanted
prendre	take
livre	book
bibliothèque	library
simplement	simply
ma	my
culture	culture
générale	general
peu	little
tremblante	trembling
lui	him
tendit	handed
l'ennui	boredom
c'est	it is
trouve	find
réserve	reserve
alors	then
besoin	need
autorisation	authorization
écrite	written
je	I
crois	believe
m'aiderait	help me
beaucoup	a lot
comprendre	understand
vous	you
avez	have
écrit	written
vadrouilles	mops
avec	with
goules	ghouls
sujet	about
venins	venoms
action	action
lente	slow
ah	ah
s'exclama	exclaimed
prenant	taking
large	wide
sourire	smile
peut-être	maybe
mon	my
préféré	favorite
t'a	you
plu	plu
oh	oh
oui	yes
répondit	replied
enthousiasme	enthusiasm
j'ai	I
adoré	loved
chapitre	chapter
où	where
racontez	tell
comment	how
attrapé	caught
une	a
goule	ghoul
passoire	strainer
thé	tea
suis	am
sûr	course
personne	person
ne	do
m'en	me
voudra	want to
permettre	allow
meilleure	best
élève	student
l'école	the school
d'accroître	increase
connaissances	knowledge
chaleureusement	warmly
énorme	huge
plume	pen
paon	peacock
parut	appeared
scandalisé	scandalized
mais	but
crut	believed
voir	see
l'expression	the expression
son	its
visage	face
réaction	reaction
admirative	admiring
est	is
jolie	pretty
n'est-ce	is this
pas	not
dit-il	he said
d'habitude	usually
sers	sers
dédicacer	autograph
mes	my
griffonna	scribbled
signature	signature
lettres	letters
rondes	round
donné	given
rendit	made
tandis	while
qu'hermione	as hermione
repliait	drew
fébrilement	feverishly
fourrait	fourrait
sac	bag
demain	tomorrow
premier	first
match	match
quidditch	quidditch
saison	season
gryffondor	gryffindor
contre	against
serpentard	slytherin
ça	it
entendu	heard
dire	say
tu	you
étais	was
joueur	player
efficace	effective
moi-même	myself
joué	played
poste	post
d'attrapeur	of monkey net
on	it
m'a	me
proposé	proposed
d'entrer	to enter
l'équipe	the team
nationale	national
consacrer	devote
vie	life
combat	combat
forces	forces
mal	evil
si	if
jamais	never
as	as
quelques	a few
conseils	tips
n'hésite	do not hesitate
surtout	especially
demander	ask
serais	would be
ravi	ravi
faire	do
profiter	enjoy
encore	yet
débutant	beginner
laissa	let
échapper	escape
gorge	throat
bruit	noise
indéfinissable	indefinable
puis	then
sortit	went out
n'arrive	arrives
y	there
croire	believe
chemin	path
tous	all
trois	three
contemplaient	contemplated
air	air
ébahi	wow!
n'a	did
même	even
lu	read
titre	title
qu'on	we
voulait	wanted
vraiment	really
parfait	perfect
crétin	moron
s'en	in
fiche	sheet
a	has
eu	had
n'est	there is
protesta	protested
voix	voice
aiguë	acute
Ça	It
parce	because
ils	they
turent	silent
pénétrant	penetrating
l'atmosphère	the atmosphere
feutrée	felted
madame	mrs.
pince	clamp
bibliothécaire	librarian
était	was
femme	woman
maigre	lean
irritable	irritable
l'air	the air
vautour	vulture
famélique	half-starved
potions	potions
grands	great
pouvoirs	powers
répéta-t-elle	repeated-t-it
ton	your
soupçonneux	suspicious
essayant	trying
d'arracher	tear
mains	hands
d'hermione	of hermione
refusait	refused
lâcher	letting go
voudrais	would like to
bien	well
garder	keep
dit-elle	she said
souffle	breath
court	short
suffit	just
donner	give
sera	will be
difficile	difficult
d'avoir	to have
autre	other
autographe	autograph
signe	sign
examina	examined
attentivement	carefully
comme	as
persuadée	convinced
s'agissait	was
faux	false
fut	was
obligée	forced
d'admettre	to admit
authentique	authentic
s'éloigna	walked away
vers	to
salle	room
revint	returned
minutes	minutes
tard	later
gros	wholesale
moisi	musty
rangea	sided
soigneusement	carefully
sortirent	went out
s'efforçant	striving
marcher	walk
trop	too
vite	fast
naturel	natural
possible	possible
cinq	five
s'étaient	had
enfermés	locked
toilettes	toilet
mimi	mimi
geignarde	whiner
pleurait	crying
bruyamment	loudly
cabine	cabin
n'y	there
prêtaient	lent
aucune	no
attention	attention
elle-même	itself
s'intéressait	if interested
eux	them
ouvrit	opened
précaution	caution
précieux	precious
volume	volume
penchèrent	immediately
pages	pages
piquetées	piquetées
taches	spots
d'humidité	moisture
comprenait	included
coup	blow
d'œil	eye
pourquoi	why
conservé	retained
certaines	some
avaient	had
effets	effects
terrifiants	terrifying
quoi	what
avoir	have
nausée	nausea
regardant	looking at
illustrations	illustrations
voilà	this is
surexcité	excited
lorsqu'elle	when it
eut	had
trouvé	found
page	page
indiquait	indicated
recette	recipe
polynectar	polynectar
accompagnée	accompanied
dessins	drawings
représentant	representative
plusieurs	several
personnes	people
aux	the
différents	different
stades	stages
leur	their
transformation	transformation
quelqu'un	someone
d'autre	on the other
espérait	hoped
cœur	heart
souffrance	suffering
n'était	there was
due	due
qu'à	as
l'imagination	the imagination
l'artiste	the artist
potion	potion
préparer	prepare
j'aie	I have
vue	view
chrysopes	lacewing
sangsues	leeches
sisymbre	sisymbre
polygonum	polygonum
murmura-t-elle	she whispered
suivant	following
doigt	finger
colonne	column
d'ingrédients	ingredients
facile	easy
sert	serves
là	there
regardez	watch
corne	horn
bicorne	bicorne
poudre	powder
me	me
demande	request
va	will
trouver	find
peau	skin
serpent	snake
d'arbre	tree
cap	cape
aussi	also
dur	hard
sans	without
compter	from
petit	small
celui	the
dont	which
veut	wants to
l'apparence	the appearance
pardon	forgiveness
coupa	cut
qu'est-ce	what is this
entends	hear
par	by
refuse	refuses
boire	drink
truc	trick
contiendrait	would
ongle	nail
d'orteil	toe
crabbe	crabbe
semblant	pretend
l'avoir	have
occuper	care
maintenant	now
dernier	last
moment	time
faut	must
rajouter	add
resta	remained
tourna	turned
s'inquiétait	worried
chose	thing
te	te
rends	give
compte	account
devoir	duty
voler	fly
faudra	will
aller	go
chercher	search
réserves	reservations
particulières	special
rogue	rogue
sais	know
bonne	good
idée	idea
referma	closed
sec	dry
peur	fear
deux	two
d'accord	agreement
grosses	large
rouges	red
s'étalaient	lined
joues	cheeks
yeux	eyes
étaient	were
brillants	brilliant
l'ordinaire	the ordinary
tiens	want
absolument	absolutely
choses	things
interdites	prohibited
savez	know
vouloir	want to
renvoyer	return
enfants	children
moldus	muggle
paraît	seems
grave	serious
délicate	delicate
voulez	want to
sache	know
malefoy	malfoy
retourne	returns
suite	suite
rendre	make
n'en	do
parle	speaks
doutais	suspected
qu'un	a
jour	day
serait	would be
toi	you
nous	we
inciterais	would urge
fabriquons	manufacture
d'ongle	nail
pied	foot
combien	how
temps	time
demanda	asked
retrouvé	found
humeur	mood
rouvrit	reopened
etant	since
doit	must
être	be
cueilli	culled
pleine	full
lune	moon
cuire	cook
pendant	during
vingt	twenty
jours	days
pense	think
mois	months
arrivons	come
réunir	together
ingrédients	ingredients
d'ici	here
aura	will
d'attaquer	attack
toute	any
façon	how
toutefois	however
vérifiait	checked
environs	surrounding area
l'oreille	the ear
arrivais	could
tomber	fall
balai	broom
éviterait	avoid
travail	work
réveilla	woke up
heure	time
samedi	Saturday
allongé	lying
bon	good
pensant	thinking
devait	should
lieu	place
heures	hours
appréhendait	had been dreading
dubois	dubois
cas	case
perdrait	lose
l'inquiétait	the worried
c'était	it was
d'affronter	face
équipe	team
montée	climb
meilleurs	best
balais	brushes
puisse	can
tel	such
désir	desire
battre	beat
bout	end
demi-heure	a half-hour
passée	past
ruminer	mull over
pensées	thoughts
leva	rose
descendit	went down
déjeuner	breakfast
grande	great
retrouva	found
autres	other
joueurs	players
tendus	tense
silencieux	silent
avant	before
onze	eleven
prit	took
direction	management
stade	stage
au-dehors	outside
lourde	heavy
l'orage	the storm
précipitèrent	ran
souhaiter	wish
chance	chance
l'entrée	the entry
vestiaires	locker rooms
revêtirent	put
robes	dresses
s'assirent	sat
écouter	listen
l'habituel	the usual
discours	speech
d'encouragement	encouragement
qu'olivier	olivier
prononçait	said
chaque	each
ont	have
servirait	would
rien	nothing
nier	deny
avons	have
nos	our
sommes	are
entraînés	trained
qu'eux	that they
volé	stolen
allons	will
regretter	regret
sont	are
vendus	sold
détritus	trash
devras	will have to
montrer	show
père	father
riche	rich
attrapeur	monkey net
digne	worthy
nom	name
saisis-toi	seized-you
vif	bright
d'or	gold
donne	gives
ta	your
cela	this
nécessaire	necessary
car	because
aujourd'hui	today
remportions	both winning
victoire	victory
mettre	put
pression	pressure
fred	fred
adressant	sending
clin	clin
immense	huge
clameur	clamor
monta	went up
tribunes	forums
lorsqu'ils	when they
pénétrèrent	penetrated
terrain	field
acclamations	cheers
dominaient	dominated
supporters	supporters
serdaigle	ravenclaw
poufsouffle	hufflepuff
souhaitaient	wanted
défaite	defeat
ces	these
derniers	last
comptaient	had
suffisamment	enough
partisans	supporters
entende	hear
également	also
sifflets	whistles
huées	boos
bibine	booze
flint	flint
serrer	tighten
qu'ils	they
firent	did
échangeant	exchanging
regards	looks
menaçants	threatening
s'écrasant	crashing
mutuellement	mutually
doigts	fingers
sifflet	whistle
accompagnés	accompanied
hurlements	howling
foule	crowd
quatorze	fourteen
s'élevèrent	rose
airs	air
sous	under
ciel	sky
plomb	lead
volait	flying
au-dessus	above
cherchant	seeking
balafré	scarred
lança	launched
filant	spinning
fusée	rocket
juste	just
au-dessous	below
démonstration	demonstration
vitesse	speed
n'eut	had
répliquer	replicate
noir	black
fonça	rushed
l'évita	the evita
sentit	felt
vent	wind
décoiffer	décoiffer
cheveux	hair
passage	passage
george	george
passant	from
devant	before
batte	bat
dévier	swerve
adverse	opposing
vit	lives
puissant	powerful
envoya	sent
d'adrian	adrian
pucey	pucey
changea	changed
trajectoire	path
aussitôt	as soon
piqué	stung
l'éviter	avoid
parvint	managed
envoyer	send
cette	this
fois	time
boomerang	boomerang
accéléra	accelerated
brutalement	brutally
fila	fila
l'autre	the other
entendait	heard
suivait	followed
sifflant	whistling
passait-il	was it
cognards	cognards
s'acharnaient	were baited
seul	only
contraire	contrary
désarçonner	dismounting
attaquant	attacker
hasard	random
weasley	weasley
attendait	waiting
extrémité	end
baissa	lowered
tête	head
frappait	hit
toutes	all
dévia	deflected
enfin	finally
course	race
fait	fact
triomphant	triumphant
tort	wrong
attiré	attracted
aimant	magnet
nouveau	new
obligé	forced
fuite	leak
maximum	maximum
commencé	started
pleuvoir	rain
sentait	felt
gouttes	drops
s'écraser	crashing
éclaboussant	splashing
lunettes	glasses
déroulait	place
jusqu'à	up to
lee	lee
jordan	jordan
mène	leads
soixante	sixty
points	points
zéro	zero
aucun	no
doute	doubt
serpentards	serpentards
montraient	showed
supériorité	superiority
temps-là	time
pouvait	could
essayer	try
d'abattre	shoot
obligés	forced
près	near
protéger	protect
d'apercevoir	see
moins	less
l'attraper	the catch
trafiqué	tampered with
grommela	grumbled
brandissant	waving
l'éloigner	away
siffler	whistle
mi-temps	half-time
donna	donna
tour	tour
salvateur	saving
foncèrent	foncèrent
sol	soil
toujours	always
d'éloigner	away
passe	pass
moqueries	teasing
train	train
écraser	crush
fabriquais	building
quand	when
empêché	prevented
angelina	angelina
marquer	mark
dix	ten
mètres	meters
d'arrêter	stop
fracasser	sunder
crâne	skull
répliqua	replied
colère	anger
l'a	the
arrêté	stopped
harceler	harass
dû	due
l'ensorceler	the bewitch
pourtant	yet
restés	stayed
clé	key
notre	our
dernière	last
séance	session
d'entraînement	training
parfaitement	perfectly
normaux	normal
moment-là	time
inquiète	concerned
volez	fly
autour	around
arrêt	stop
n'arriverai	do not get
attraper	catch
sauf	except
s'il	if it
vient	comes
manche	sleeve
occupez-vous	do you
charge	load
sois	am
idiot	idiot
t'arracher	break away
olivier	olivier
absurdité	absurdity
alicia	alicia
spinnet	spinnet
furieux	furious
peut	can
laisser	let
face	in the face of
machin	machin
enquête	survey
interrompt	interrupts
déclare	said
forfait	package
cause	cause
débrouille	doing
entièrement	fully
faute	fault
quelle	what
idiotie	idiocy
pareilles	such
venait	came
rejoindre	join
reprendre	resume
demanda-t-elle	he asked as she
celui-ci	it
jeta	threw
paraissait	seemed
déterminé	determined
laissez-le	let the
débrouiller	manage
pluie	rain
tombait	fell
dru	dru
présent	this
s'éleva	rose
entendit	heard
bientôt	soon
sifflement	whistle
trahissait	betrayed
présence	presence
haut	top
cercles	circles
tonneaux	barrels
zigzags	zigzags
piqués	books
remontées	lift
chandelle	candle
éviter	avoid
poursuivant	continuing
étourdi	dizzy
gardait	kept
ouverts	open
martelait	pounding
narines	nostrils
lorsqu'il	when it
retourna	returned
bas	the bottom
nouvelle	new
attaque	attack
spectateurs	spectators
rire	laugh
gradins	bleachers
savait	knew
ridicule	ridiculous
exécutant	running
figures	figures
elles	they
efficaces	effective
lourd	heavy
changer	change
facilement	easily
exercice	exercise
montagnes	mountains
russes	Russian
observant	observing
travers	through
rideau	curtain
buts	goals
subissaient	were
oreilles	ears
indiqua	said
frôler	graze
virage	turn
opposée	opposite
prépares	prepare
ballet	ballet
aérien	air
potter	potter
cria	cried
après	after
évité	avoided
regard	look
haine	hate
aperçut	saw
voletait	flew
centimètres	centimeters
gauche	left
occupé	busy
moquer	fun
l'avait	had
vu	seen
terrible	terrible
place	place
oser	dare
foncer	create
lève	up
aperçoive	noticing
vlam	vlam
hésité	hesitated
instant	now
l'atteindre	the reach
plein	full
fouet	whip
cassant	breaking
bras	arm
etourdi	etourdi
douleur	pain
fulgurante	dazzling
glissa	slipped
côté	side
ruisselant	dripping
droit	right
inerte	inert
long	long
flanc	flank
deuxième	second
frapper	hit
embardée	swerve
n'ayant	having
qu'une	a
seule	only
cerveau	brain
embrumé	misty
aveuglé	blinded
fondit	burst
luisant	shiny
goguenard	bantering
drago	drago
écarquilla	écarquilla
soudain	suddenly
terrorisé	terrorized
persuadé	persuaded
l'attaquait	attacked
s'exclama-t-il	exclaimed,-t-he
s'enfuyant	on the run
lâcha	released
tenait	held
valide	valid
geste	gesture
désespéré	desperate
d'attraper	to catch
refermer	close
petite	small
sphère	sphere
glacée	ice
qu'avec	with
jambes	legs
mit	mit
hurler	scream
plongea	dove
s'évanouir	vanish
sourd	deaf
tomba	fell
boue	mud
recouvrait	covered
roula	roula
terre	earth
tordu	twisted
formant	forming
angle	angle
inquiétant	worrying
terrassé	floored
vaguement	vaguely
cris	cree
retentissaient	resounded
serrait	tightened
gagné	won
murmura-t-il	he murmured
s'évanouit	faints
reprit	took
connaissance	knowledge
continuait	continued
marteler	hammer
penché	leaning
rangée	row
dents	teeth
étincelantes	sparkling
non	not
gémit-il	moans-it
sait	knows
claironnante	claironnante
l'adresse	the address
pressaient	pressed
anxieux	anxiety
t'inquiète	don't worry
vais	'll
soigner	treat
préfère	prefer
essaya	tried
relever	meet
atroce	atrocious
déclic	click
familier	familiar
n'ai	haven
photos	photos
colin	colin
s'écria-t-il	cried it
force	force
reste	rest
apaisante	soothing
sortilège	hex
très	very
simple	simple
utilisé	used
l'infirmerie	the infirmary
serrées	tight
préférable	best
approuva	approved
couvert	covered
s'empêcher	help
largement	widely
malgré	despite
blessure	injury
bravo	bravo
magnifique	beautiful
spectaculaire	spectacular
joli	nice
aies	have
réussi	successful
rangées	rows
alignées	aligned
s'efforçaient	trying
grand-peine	great difficulty
d'enfermer	lock
boîte	box
acharné	hard
découdre	fight
reculez-vous	back away-you
retroussant	rolling up
manches	short
robe	dress
vert	green
jade	jade
faiblement	low
continua	continued
moulinets	reels
baguette	wand
magique	magic
pointa	pointa
sensation	sensation
étrange	strange
désagréable	unpleasant
répandit	spread
l'épaule	the shoulder
jusqu'au	until the
l'impression	printing
dégonflait	dégonflait
vieux	old
pneu	tire
fermés	closed
n'osait	did not dare to
regarder	watch
passait	passed
pires	the worst
craintes	fears
trouvèrent	found
confirmées	confirmed
exclamations	exclamations
stupéfaites	astonished
auxquelles	which
mêlait	mixed
cliquetis	rattling
frénétique	frantic
appareil	device
photo	photo
effet	effect
produire	produce
l'essentiel	the essential
os	os
cassés	broken
l'esprit	the spirit
eh	eh
mr	mr
miss	miss
granger	granger
pouvez-vous	can you
l'accompagner	accompany
là-bas	there
plaît	please
pomfresh	pomfresh
n'aura	will
arranger	arrange
releva	rose
étrangement	strangely
bancal	wobbly
profonde	deep
inspiration	inspiration
résolut	resolved
quel	what
état	state
trouvait	was
faillit	almost
voyait	saw
dépasser	exceed
ressemblait	looked like
gant	glove
caoutchouc	rubber
couleur	color
chair	flesh
remuer	stir
produisit	produced
ressoudé	ressoudé
disparaître	disappear
furieuse	furious
auriez	would
venir	come
immédiatement	immediately
ici	here
fulmina-t-elle	stormed toward it
soulevant	lifting
amorphe	amorphous
peux	can
ressouder	resolder
secondes	seconds
repousser	push
allez	go
arriver	getting
j'y	I
arriverai	get
douloureux	painful
sombre	dark
jetant	throwing
pyjama	pajamas
passer	pass
nuit	night
attendit	waited
entourait	surrounded
lit	bed
l'aidait	helped
enfiler	thread
fallut	took
certain	some
entrer	enter
caoutchouteux	rubbery
veste	jacket
admires	admire
autant	as much
envie	want
d'être	to be
transformé	transformed
mollusque	mollusk
l'aurait	would have
demandé	asked
monde	world
commettre	commit
erreurs	errors
d'ailleurs	moreover,
n'est-ce-pas	is-this-not
rebondit	bounces
chiffon	cloth
passèrent	passed
bouteille	bottle
l'étiquette	the label
poussoss	poussoss
vas	vas
mauvaise	bad
prévint-elle	warned-it
versant	slope
liquide	liquid
fumant	smoking
bol	bowl
qu'elle	it
avala	swallowed
bouche	mouth
feu	fire
tousser	cough
alla	alla
pestant	railing
sports	sports
dangereux	dangerous
professeurs	teachers
incompétents	incompetent
soin	care
d'aider	help
avaler	swallow
d'eau	water
incroyable	amazing
fallait	had to
tuer	kill
j'aimerais	I would like to
savoir	know
fabriqué	manufactured
sombrement	darkly
ajouter	add
liste	list
questions	questions
poser	ask
pris	taken
s'enfonçant	sinking
oreillers	pillows
j'espère	I hope
meilleur	best
goût	taste
horreur	horror
rigoles	flutes
bouts	tips
dedans	in
impossible	impossible
porte	door
s'ouvrit	opened
volée	fly
sales	sales
ruisselants	ruisselants
venaient	came
saluer	greet
extraordinaire	extraordinary
viens	just
marcus	marcus
savon	soap
hurlant	screaming
menait	led
apporté	brought
gâteaux	cakes
bonbons	candy
jus	juice
citrouille	pumpkin
s'installèrent	settled
improvisèrent	improvised
promettait	promised
belle	beautiful
fête	feast
surgit	arises
garçon	boy
repos	rest
trente-trois	thirty-three
dehors	outside
distraction	distraction
lancinante	throbbing
transperçait	pierced
cri	cry
rempli	filled
d'échardes	splinters
réveillé	woke up
poussa	pushed
d'horreur	horror
rendant	making
éponger	mop up
front	front
l'obscurité	the dark
laissez-moi	let me
tranquille	quiet
reconnut	recognized
dobby	dobby
énormes	huge
l'elfe	the elf
balle	ball
tennis	tennis
ténèbres	darkness
larme	tear
coulait	flowed
nez	nose
pointu	sharp
revenu	income
consterné	appalled
cessé	stopped
garde	guard
monsieur	mr.
n'avez-vous	have you
écouté	listened to
n'est-il	is it
retourné	returned
chez	in
raté	missed
souleva	raised
repoussa	pushed
l'éponge	the sponge
fais	do
sais-tu	do you know
lèvres	lips
mirent	started
trembler	shake
soupçon	hint
lentement	slowly
bloqué	blocked
barrière	barrier
vrai	true
hocha	hocha
vigoureusement	vigorously
ailes	wings
s'est	is
caché	hidden
attendu	expected
brûlé	burned
fer	iron
repasser	iron
punir	punish
montra	showed
longs	long
entourés	surrounded
bandages	bandages
fichait	didn't care
pensait	thought
sécurité	security
n'aurait	would
cru	raw
d'autres	other
moyens	means
balançait	rocking
d'avant	before
arrière	rear
hochant	nodding
grosse	big
repoussante	repulsive
reçu	received
choc	shock
appris	learned
poudlard	hogwarts
laissé	left
brûler	burn
dîner	dinner
maître	master
telle	such
correction	correction
retomber	fall
failli	bankrupt
renvoyés	returned
moi	me
ferais	would
filer	spinning
aient	have
repoussé	pushed
sinon	otherwise
t'étrangle	you strangles
faible	low
habitué	used
menaces	threats
mort	death
reçoit	receives
maison	home
maîtres	masters
moucha	blew her nose
taie	pillowcase
d'oreiller	pillow
crasseuse	grimy
vêtement	garment
pitoyable	pitiful
quitter	leave
t'habilles-tu	you wear you
demanda-t-il	he asked
intrigué	intrigued
montrant	showing
distinctif	distinctive
elfes	elves
tenus	required
esclavage	slavery
libéré	released
offrent	offer
vêtements	clothing
famille	family
chaussette	sock
libre	free
essuya	wiped
s'écria	cried
retourner	return
croyait	believed
suffirait	would
sentant	feeling
revenir	return
veux	want to
essayé	tried
choqué	shocked
sauver	save
vaut	worth
rentre	returns
grièvement	seriously
blessé	injured
plutôt	rather
rester	stay
soit	either
renvoyé	returned
fureur	fury
j'imagine	I guess
tant	as
petits	small
morceaux	pieces
seulement	only
gémit	moans
larmes	tears
lambeaux	shreds
représente	represents
humbles	humble
esclaves	slaves
rebut	scrap
magie	magic
souvient	remember
celui-dont-on-ne-doit-	he-who-are-not-must-
pas-prononcer-le-nom	't-pronounce-the-name
sommet	summit
puissance	power
étions	were
traités	treaties
vermine	vermin
traité	treaty
admit-il	admitted it
s'essuyant	wiping
d'entre	of
améliorée	improved
triomphé	triumphed
celui-dont-on-ne-doit-pas-prononcer-le-nom	he-who-are-not-must-not-pronounce-the-name
survécu	survived
pouvoir	power
seigneur	lord
été	been
brisé	broken
aube	dawn
brillait	shone
flamme	flame
d'espérance	hope
ceux	those
pensaient	thought
sombres	dark
finiraient	would
terribles	terrible
préparent	prepare
qu'elles	they
produisent	produce
cet	this
demeurer	stay
l'histoire	the story
point	point
répéter	repeat
chambre	room
secrets	secrets
ouverte	open
figea	froze
frappé	hit
saisit	captures
table	table
chevet	bedside
carafe	decanter
abattit	cut down
propre	own
s'effondra	collapsed
réapparut	reappeared
louchant	squinting
marmonnant	mumbling
méchant	nasty
donc	so
existe	there is
dis	say
déjà	already
passé	past
raconte-moi	tell me
attrapa	caught
poignet	wrist
squelettique	skeletal
essayait	tried
né	born
parents	parents
devrais-je	should I
contient	contains
demandez	ask
pauvre	poor
exorbités	bulging
prépare	prepares
actions	shares
château	castle
s'y	there
lorsqu'elles	when they
produiront	will
retournez	return
mêlé	mixed
est-ce	is this
tenant	taking into
fermement	firmly
l'empêcher	prevent
ouvert	open
couina	couina
rentrez	tuck
question	question
parte	parte
l'une	one
meilleures	best
amies	friends
née	born
premières	first
cibles	targets
risque	risk
amis	friends
sorte	so
d'extase	ecstasy
noble	noble
courageux	brave
grandes	large
frémissantes	quivering
bruits	noise
provenaient	came
couloir	hallway
partir	from
souffla	blew
terrifié	terrified
craquement	crunch
sonore	sound
vide	empty
fixés	set
rapprochaient	closer
dumbledore	dumbledore
pénétra	penetrated
reculons	backwards
vêtu	dressed
longue	long
coiffé	wearing
bonnet	bonnet
portait	wore
l'extrémité	the end
objet	object
semblait	seemed
statue	statue
mcgonagall	mcgonagall
apparut	appeared
portant	bearing
déposèrent	filed
passa	spent
disparut	disappeared
immobile	still
faisant	making
dormir	sleep
parlaient	spoke
précipitamment	hurriedly
suivie	followed
enfilait	put on
cardigan	cardigan
chemise	shirt
s'est-il	is there
chuchota	whispered
penchant	leaning
agression	aggression
minerva	minerva
l'escalier	the stairs
grappe	cluster
raisins	grapes
visite	visit
estomac	stomach
contracter	contract
douloureusement	painfully
allongée	elongated
lueur	glow
rayon	radius
permit	allowed
reconnaître	recognize
crivey	crivey
tendues	tense
pétrifié	petrified
frissonne	shiver
d'y	there
penser	think
albus	albus
descendu	down
aurait	would
pu	could
observèrent	watched
longuement	long
pencha	bent
arracha	tore
l'appareil	the device
figées	frozen
pensez	think
agresseur	aggressor
miséricorde	mercy
jet	jet
vapeur	steam
jaillit	springs
odeur	smell
acre	acre
plastique	plastic
fondu	melted
songeur	pensive
pellicule	film
signifie	means
bel	beautiful
plaqua	wood, and overlaid
regarda	looked at
ronds	round
d'après	after
