14	14
cornelius	cornelius
fudge	fudge
harry	harry
ron	ron
et	and
hermione	hermione
savaient	knew
depuis	since
toujours	always
que	that
hagrid	hagrid
avait	had
malheureusement	unfortunately
un	a
faible	low
pour	for
les	the
créatures	creatures
géantes	giant
monstrueuses	monstrous
au	the
cours	during
de	of
leur	their
première	first
année	year
à	to
poudlard	hogwarts
il	it
essayé	tried
d'élever	to raise
dragon	dragon
dans	in
sa	its
cabane	hut
sans	without
parler	talk
l'énorme	the huge
chien	dog
trois	three
têtes	heads
baptisé	baptized
touffu	bushy
qu'ils	they
n'étaient	there were
pas	not
près	near
d'oublier	forget
si	if
temps	time
où	where
était	was
élève	student
entendu	heard
d'un	a
monstre	monster
caché	hidden
le	the
château	castle
n'y	there
rien	nothing
d'étonnant	amazing
ce	this
qu'il	it
ait	has
tout	all
fait	fact
découvrir	discover
l'apprivoiser	the tame
doute	doubt
scandalisé	scandalized
par	by
la	the
longue	long
captivité	captivity
créature	creature
dû	due
estimer	estimate
qu'elle	it
méritait	deserved
bien	well
dégourdir	stretch
peu	little
ses	its
nombreuses	many
pattes	legs
imaginait	imagined
très	very
treize	thirteen
ans	years
essayant	trying
passer	pass
collier	necklace
une	a
laisse	leaves
mais	but
également	also
certain	some
jamais	never
n'aurait	would
cherché	sought
tuer	kill
quelqu'un	someone
a	has
présent	this
regrettait	regretted
presque	almost
d'avoir	to have
découvert	discovered
secret	secret
du	the
journal	journal
jedusor	jedusor
peut-être	maybe
n'était	there was
coupable	guilty
suggéra	suggested
c'était	it was
autre	other
qui	that
attaquait	attacked
élèves	students
tu	you
crois	believe
y	there
tellement	so
monstres	monsters
répliqua	replied
ton	your
maussade	gloomy
on	it
su	su
été	been
renvoyé	returned
dit	said
consterné	appalled
agressions	assault
ont	have
cesser	stop
après	after
l'expulsion	the expulsion
sinon	otherwise
obtenu	obtained
récompense	reward
essaya	tried
voir	see
choses	things
sous	under
angle	angle
différent	different
me	me
penser	think
percy	percy
dit-il	he said
d'abord	first
lui	him
demandé	asked
dénoncer	denounce
tué	killed
fit	fit
remarquer	notice
aurait	would
obligé	forced
retourner	return
orphelinat	orphanage
moldus	muggle
fermé	closed
je	I
comprends	understand
préféré	favorite
rester	stay
ici	here
se	is
mordit	bit
lèvres	lips
as	as
rencontré	met
l'allée	the aisle
des	of
embrumes	embrumes
n'est-ce	is this
risqua-t-il	risked-t-he
cherchait	was looking for
produit	product
contre	against
limaces	slugs
répondit	replied
aussitôt	as soon
eut	had
long	long
silence	silence
puis	then
d'une	a
voix	voice
hésitante	hesitant
aborda	approached
question	question
cruciale	crucial
vous	you
croyez	believe
qu'on	we
devrait	should
aller	go
ça	it
serait	would be
joyeux	happy
comme	as
visite	visit
bonjour	hello
est-ce	is this
pourriez	could
nous	we
dire	say
avez	have
lâché	let go
sanguinaire	bloodthirsty
poilu	hairy
ces	these
derniers	last
finalement	finally
ils	they
décidèrent	decided
ne	do
sauf	except
s'il	if it
nouvelle	new
agression	aggression
jours	days
passèrent	passed
désincarnée	disembodied
manifeste	manifest
nouveau	new
avaient	had
l'espoir	hope
avoir	have
demander	ask
pourquoi	why
maintenant	now
quatre	four
mois	months
justin	justin
nick	nick
quasi-sans-tête	quasi-without-head
pétrifiés	petrified
monde	world
ou	or
semblait	seemed
convaincu	convinced
l'agresseur	the attacker
quel	what
fût	was
définitivement	definitely
renoncé	waived
agir	act
peeves	peeves
s'était	had
lassé	tired
potter	potter
vipère	viper
ernie	ernie
macmillan	macmillan
lui-même	himself
montré	shown
aimable	kind
avec	with
pendant	during
botanique	botanical
mars	march
racines	roots
mandragore	mandrake
organisèrent	organized
fête	feast
bruyante	noisy
endiablée	furious
serre	greenhouse
n°3	n°3
professeur	professor
chourave	chourave
en	in
fut	was
enchantée	enchanted
dès	as soon
qu'elles	they
commenceront	begin
sortir	out
leurs	their
pots	pots
rendre	make
unes	each
aux	the
autres	other
sera	will be
signe	sign
atteint	reached
maturité	maturity
dit-elle	she said
pourrons	can
alors	then
ramener	bring
vie	life
malheureux	unhappy
lorsque	when
pâques	easter
arriva	came to pass
deuxième	second
eurent	had
quoi	what
réfléchir	think
vacances	holiday
car	because
moment	time
venu	come
eux	them
choisir	choose
matières	materials
souhaitaient	wanted
étudier	study
troisième	third
prenait	took
sujet	about
sérieux	serious
c'est	it is
déterminant	determining
notre	our
avenir	future
examinant	examining
liste	list
options	options
proposées	proposed
moi	me
veux	want to
abandonner	abandon
potions	potions
impossible	impossible
air	air
sombre	dark
est	is
garder	keep
fondamentales	the fundamental
j'aurais	I would have
laissé	left
tomber	fall
défense	defence
forces	forces
mal	evil
important	important
protesta	protested
ulcérée	ulcerated
façon	how
dont	which
l'enseigne	the sign
lockhart	lockhart
seule	only
chose	thing
m'ait	I have
apprise	learned
faut	must
libérer	free
lutins	goblins
cage	cage
savait	knew
quelles	what
laquelle	which
vraiment	really
doué	gifted
quidditch	quidditch
finit	ends
donc	so
prendre	take
mêmes	same
difficultés	difficulties
suivre	follow
moins	less
ami	friend
l'aider	the help
prochain	next
match	match
devait	should
opposer	object
l'équipe	the team
gryffondor	gryffindor
celle	the
poufsouffle	hufflepuff
séances	sessions
d'entraînement	training
lieu	place
tous	all
soirs	night
veille	eve
estima	estima
chances	chances
remporter	win
coupe	cup
n'avaient	had
meilleures	best
son	its
humeur	mood
joyeuse	joyful
courte	short
durée	duration
cependant	however
haut	top
marches	steps
menaient	led
dortoir	dormitory
tomba	fell
sur	on
neville	neville
londubat	londubat
états	states
sais	know
j'ai	I
trouvé	found
poussa	pushed
porte	door
regardant	looking at
apeuré	frightened
vit	lives
valise	suitcase
vidée	emptied
contenu	content
jeté	cast
sens	meaning
cape	cape
déchirée	torn
étalée	spread
terre	earth
draps	sheets
couvertures	blankets
arrachés	torn
lit	bed
tiroirs	drawers
commode	convenient
retournés	returned
matelas	mattress
stupéfait	stunned
contempla	stared at
désastre	disaster
dean	dean
seamus	seamus
arrivèrent	arrived
même	even
juron	curse
toniruante	toniruante
qu'est-ce	what is this
s'est	is
passé	past
aucune	no
idée	idea
celui-ci	it
examina	examined
vêtements	clothing
répandus	common
alentour	around
toutes	all
poches	pockets
retournées	returned
celui	the
objet	object
précis	specific
quelque	some
te	te
manque	lack
rassembla	together
affaires	business
remit	gave
seulement	only
lorsqu'il	when it
rangé	tidy
dernier	last
livre	book
sut	sut
disparu	gone
n'est	there is
plus	more
là	there
chuchota-t-il	whispered-t-he
l'oreille	the ear
tête	head
direction	management
suivit	followed
au-dehors	outside
redescendirent	climbed back down
hâte	looking forward
salle	room
commune	common
moitié	half
vide	empty
rejoignirent	joined
occupée	occupied
lire	read
coin	corner
lorsqu'ils	when they
raconté	told
l'air	the air
atterré	aghast
forcément	necessarily
l'a	the
volé	stolen
personne	person
d'autre	on the other
connaît	knows
mot	word
passe	pass
exactement	exactly
approuva	approved
lendemain	next day
faisait	was
soleil	sun
radieux	radiant
petite	small
brise	breeze
rafraîchissait	rafraîchissait
l'atmosphère	the atmosphere
idéal	ideal
s'exclama	exclaimed
dubois	dubois
enthousiasme	enthusiasm
attaquant	attacker
petit	small
déjeuner	breakfast
n'avait	had
cessé	stopped
d'observer	observe
visages	faces
rassemblés	gathered
autour	around
table	table
demandant	asking
l'un	one
d'eux	of them
intime	intimate
l'avait	had
incité	prompted
signaler	report
vol	flight
n'aimait	never liked
trop	too
cette	this
fallu	had to
révèle	reveals
toute	any
l'histoire	the story
souhaitait	wanted
raviver	revive
souvenir	remember
quitta	left
grande	great
compagnie	company
d'hermione	of hermione
chercher	search
équipement	equipment
souci	concern
grave	serious
encore	yet
revint	returned
tourmenter	torment
peine	penalty
avait-il	had he
posé	asked
pied	foot
marche	walking
l'escalier	the stairs
entendit	heard
fois	time
déchirer	rip
écorcher	skinning
cri	cry
sursauter	jump
s'exclama-t-il	exclaimed,-t-he
par-dessus	above
épaule	shoulder
viens	just
l'entendre	hear
yeux	eyes
écarquillés	wide open
non	not
frappa	hit
soudain	suddenly
front	front
plat	flat
main	hand
comprendre	understand
j'aille	I go
bibliothèque	library
elle	it
monta	went up
compris	including
demanda	asked
regardait	watched
essayer	try
localiser	locate
beaucoup	a lot
hochant	nodding
faut-il	does it
aille	go
haussement	shrug
d'épaules	shoulder
fonce	dark
indécis	undecided
bougé	moved
d'entendre	to hear
derrière	behind
quittaient	left
tour	tour
grand	great
bruit	noise
conversations	conversations
sortaient	out
parc	park
stade	stage
ferais	would
d'y	there
onze	eleven
heures	hours
va	will
bientôt	soon
commencer	start
dépêcha	dispatched
d'aller	go
nimbus	nimbus
2000	2000
rejoignit	joined
foule	crowd
nombreuse	large
pressait	pressed
continuait	continued
préoccuper	concern
n'arrivait	there was
chasser	hunt
esprit	spirit
pensée	thought
réconfortante	comforting
retrouva	found
vestiaires	locker rooms
subiraient	would
tant	as
seraient	would be
deux	two
équipes	teams
s'avancèrent	advanced
pelouse	lawn
tonnerre	thunder
d'applaudissements	applause
madame	mrs.
bibine	booze
lâcha	released
balles	balls
tandis	while
joueurs	players
vêtus	dressed
robes	dresses
jaune	yellow
canari	canary
écoutaient	listened to
conseils	tips
dernière	last
minute	minute
capitaine	captain
venait	came
d'enfourcher	riding
balai	broom
mcgonagall	mcgonagall
traversa	crossed
marchant	walking
courant	current
énorme	huge
mégaphone	megaphone
violet	purple
l'impression	printing
cœur	heart
tombait	fell
pierre	stone
poitrine	chest
annulé	cancelled
annonça	announced
explosion	explosion
cris	cree
huées	boos
gradins	bleachers
olivier	olivier
précipita	rushed
vers	to
descendre	down
s'écria-t-il	cried it
absolument	absolutely
joue	plays
prêta	lent
attention	attention
continua	continued
crier	shout
doivent	must
immédiatement	immediately
donné	given
amples	more
informations	information
dépêchez-vous	hurry up
plaît	please
vaut	worth
mieux	better
veniez	come
pouvait	could
soupçonner	suspect
détacher	detach
colère	anger
courir	run
surprise	surprise
l'autorisa	the authorized
accompagner	accompany
aussi	also
weasley	weasley
réactions	reactions
étaient	were
partagées	shared
parmi	among
entouraient	surrounded
certains	some
protestaient	protesting
ouvertement	openly
l'annulation	the cancellation
d'autres	other
inquiet	worried
suivirent	followed
marbre	marble
bureau	office
emmenait	took
allez	go
choc	shock
avertit	warns
étonnamment	surprisingly
douce	soft
pris	taken
l'infirmerie	the infirmary
eu	had
double	double
sentit	felt
estomac	stomach
contracter	contract
douloureusement	painfully
entrer	enter
pomfresh	pomfresh
penchée	leaning
cinquième	fifth
longs	long
cheveux	hair
bouclés	curly
reconnut	recognized
l'élève	the student
serdaigle	ravenclaw
erreur	error
trouvait	was
serpentard	slytherin
côté	side
totalement	totally
immobile	still
vitreux	glassy
grands	great
ouverts	open
trouvées	found
montra	showed
miroir	mirror
circulaire	circular
d'elles	they
j'imagine	I guess
n'avez	do
d'explication	explanation
firent	did
quitter	leave
vais	'll
parle	speaks
compter	from
d'aujourd'hui	today
devront	will have to
regagner	return
salles	rooms
communes	common
six	six
soir	evening
passée	past
heure	time
aucun	no
devra	should
fin	end
chaque	each
accompagnera	accompany
classe	class
suivante	following
entraînements	workouts
matches	matches
sont	are
reportés	deferred
date	date
ultérieure	later
aura	will
activité	activity
écoutèrent	listen
roula	roula
parchemin	parchment
reprit	took
étouffée	choked
n'ai	haven
besoin	need
d'ajouter	add
rarement	rarely
bouleversée	upset
arrêté	stopped
faudra	will
s'attendre	expect
fermeture	closure
pure	pure
simple	simple
l'école	the school
demande	request
ceux	those
pourraient	could
renseignements	information
fournir	provide
rapport	report
communiquer	communicate
délai	time
sortit	went out
certaine	some
maladresse	clumsiness
l'ouverture	the opening
cachée	hidden
portrait	portrait
grosse	big
dame	lady
commentaires	comments
commencèrent	started
fantôme	ghost
récapitula	récapitula
lee	lee
jordan	jordan
l'ami	the friend
jumeaux	twins
semble	seems
remarqué	noticed
sains	healthy
saufs	sound
histoire	history
vient	comes
évident	obvious
l'héritier	the heir
est-	is-
renvoient	return
ajouta-t-il	he added
provoquant	causing
hochements	listening to
approbateurs	approvers
quelques	a few
applaudissements	applause
discrets	discrete
assis	sitting
fauteuil	chair
guère	little
soucieux	anxious
d'exprimer	express
point	point
vue	view
pâle	pale
abattu	shot
sonné	sounded
chuchota	whispered
george	george
fille	girl
pénélope	penelope
deauclaire	deauclaire
préfète	préfète
pensait	thought
oserait	dare
s'en	in
préfet	prefect
n'écoutait	not listened to
qu'à	as
l'image	the image
étendue	scope
d'hôpital	hospital
raide	stiff
statue	statue
risquait	could
fort	fort
d'être	to be
condamné	sentenced
chez	in
dursley	dursley
tom	tom
dénoncé	denounced
finir	finish
fermait	closed
comprenait	included
pu	could
ressentir	feel
faire	do
murmura	whispered
soupçonnent	suspect
décida	decided
n'arrive	arrives
croire	believe
soit	either
libéré	released
cinquante	fifty
doit	must
savoir	know
comment	how
pénétrer	enter
chambre	room
secrets	secrets
début	beginning
droit	right
dehors	outside
d'utiliser	use
vieille	old
mon	my
père	father
baissant	lowering
hérité	inherited
qu'une	a
d'invisibilité	invisibility
argentée	silver
seul	only
moyen	average
faufiler	sneak
hors	out
aperçoive	noticing
allèrent	went
coucher	bedroom
l'heure	the time
habituelle	usual
attendirent	waited for
soient	are
endormis	asleep
rehabillèrent	rehabillèrent
s'enveloppèrent	wrapped themselves
traversée	crossing
n'eut	had
partie	part
plaisir	fun
vieil	old
habitué	used
promenades	walks
nocturnes	night
vu	seen
autant	as much
heure-là	time
professeurs	teachers
préfets	prefects
fantômes	ghosts
sillonnaient	furrowed
couloirs	corridors
l'affût	the lookout
suspect	suspect
certes	of course
rendait	made
invisibles	invisible
supprimait	removed
bruits	noise
faillirent	almost
repérer	identify
cogna	knocked
l'orteil	the toe
mètres	meters
poste	post
d'observation	observation
qu'occupait	that was
rogue	rogue
chance	chance
éternua	sneezed
bruyamment	loudly
laissa	let
échapper	escape
enfin	finally
atteignirent	reached
soulagement	relief
portail	portal
chêne	oak
glissèrent	glissèrent
nuit	night
claire	clear
ciel	sky
rempli	filled
d'étoiles	star
hâtèrent	hurried
voyaient	saw
fenêtres	windows
éclairées	informed
n'ôtèrent	not stripped
furent	were
arrivés	arrived
devant	before
frappèrent	beat
s'ouvrit	opened
tenait	held
seuil	threshold
arbalète	crossbow
pointée	pointing
crockdur	crockdur
molosse	mastiff
aboyait	barking
oh	oh
baissa	lowered
arme	weapon
fabriquez	make
montrant	showing
l'arbalète	the crossbow
marmonna	muttered
m'attendais	was expecting
entrez	enter
asseyez-vous	sit
thé	tea
incapable	unable
regarder	watch
faillit	almost
éteindre	turn off
feu	fire
renversant	reversing
bouilloire	kettle
cassa	cassa
théière	teapot
geste	gesture
Ça	It
s'inquiéta	if worry
êtes	are
arrivé	arrived
oui	yes
brisée	broken
cessait	stopped
jeter	throw
regards	looks
fenêtre	window
versa	versa
grandes	large
tasses	cups
d'eau	water
bouillante	boiling
oublié	forgot
tranche	slice
cake	cake
s'apprêtait	was about
poser	ask
assiette	plate
lorsqu'on	when
vigoureusement	vigorously
échangèrent	exchanged
regard	look
panique	panic
recouvrirent	covered
avant	before
réfugier	refuge
vérifia	verified
rapidement	quickly
cachés	hidden
saisit	captures
alla	alla
ouvrir	open
bonsoir	hello
dumbledore	dumbledore
entra	entered
visage	face
suivi	follow-up
homme	man
d'aspect	aspect
étrange	strange
corpulent	corpulent
gris	grey
désordre	disorder
expression	expression
anxieuse	anxious
l'homme	the man
portait	wore
disparates	disparate
formaient	formed
curieux	curious
mélange	mix
costume	costume
rayures	stripes
cravate	tie
rouge	red
noire	black
bottes	boots
violettes	purple
bouts	tips
pointus	sharp
bras	arm
chapeau	hat
melon	melon
couleur	color
verte	green
patron	boss
cornélius	cornelius
ministre	minister
magie	magic
donna	donna
coup	blow
coude	elbow
taire	shut up
devenu	now
couvrait	covered
sueur	sweat
chaise	chair
regarda	looked at
alternativement	alternatively
sale	dirty
affaire	case
détachant	stain remover
syllabes	syllables
fallait	had to
j'intervienne	I should intervene
enfants	children
allées	aisles
suffisamment	enough
loin	far
ministère	department
implorant	imploring
savez	know
voudrais	would like to
clair	clear
entière	full
confiance	trust
sourcils	eyebrows
froncés	a frown
ecoutez	listen
albus	albus
l'aise	comfortable
antécédents	history
jouent	play
faveur	for
membres	members
conseil	council
d'administration	of directors
consultés	consulted
répète	repeat
qu'éloigner	away
changera	change
strictement	strictly
brillaient	shone
lueur	glow
flamboyante	flaming
mettez-vous	put yourself
ma	my
place	place
tripotant	fingering
nerveusement	nervously
tournés	shot
voie	way
s'aperçoit	see
reviendra	return
n'en	do
parlera	talk
l'emmène	the takes
devoir	duty
m'emmener	take me
mis	put
trembler	shake
évitant	avoiding
punition	punishment
précaution	caution
trouve	find
serez	will be
nos	our
excuses	apologies
n'allez	not going to
azkaban	azkaban
rugit	roars
répondre	reply
exclamation	exclamation
valut	earned
côtes	coast
lucius	lucius
malefoy	malfoy
enveloppé	wrapped
arborait	sported
sourire	smile
glacial	icy
satisfait	satisfied
mit	mit
grogner	growl
déjà	already
mr	mr
approbateur	approver
faites	do
fureur	fury
sortez	get out
maison	home
cher	dear
monsieur	mr.
soyez	be
trouver	find
votre	your
heu	uh
appelez-vous	do you call
jetant	throwing
dédaigneux	dismissive
suis	am
simplement	simply
l'on	we
m'a	me
directeur	director
vouliez-vous	did you want to
poli	polished
brillait	shone
bleus	blue
navré	sorry
nonchalant	nonchalant
sortant	outgoing
poche	pocket
rouleau	roll
estime	estimated
ordre	order
suspension	suspension
concernant	on
trouverez	find
douze	twelve
signatures	signatures
réglementaires	regulatory
avons	have
estimé	estimated
n'étiez	there were
hauteur	height
situation	situation
j'en	I
désolé	sorry
combien	how
d'agressions	assault
jusqu'à	up to
cet	this
après-midi	afternoon
rythme	pace
restera	will
enfant	child
sommes	are
conscients	aware
l'horrible	the horrible
perte	loss
cela	this
représenterait	would
attendez	wait
affolé	panic-stricken
suspendu	suspended
nomination	appointment
relève	notes
décision	decision
mettre	put
terme	term
voyons	see
peut	can
capable	able
voyait	saw
gouttes	drops
transpiration	sweating
apparaître	appear
lèvre	lip
supérieure	upper
verrons	see
déclara	said
mauvais	bad
voté	voted
leva	rose
bond	bond
hirsute	shaggy
touchait	touched
plafond	ceiling
quels	what
vos	your
arguments	arguments
convaincre	convince
rugit-il	roars-it
menaces	threats
chantage	blackmail
caractère	character
emporté	away
attirera	attract
jour	day
ennuis	trouble
conseille	advises
aurez	will
gardiens	guards
d'azkaban	of azkaban
n'aimeraient	would love
pouvez	can
renvoyer	return
hurla-t-il	"he yelled,
panier	basket
tremblant	tremblant
condamnés	sentenced
prochaine	next
morts	dead
calmez-vous	calm down
sèchement	curtly
tourna	turned
souhaite	wish
départ	starting
m'en	me
irai	go
balbutia	stammered
gronda	gronda
bleu	blue
fixait	set
glacés	icy
parlant	speaking
lentement	slowly
perde	lose
allait	would
apercevrez	see
n'aurai	will not
véritablement	truly
quitté	left
fidèle	faithful
aide	using
apportée	made
demandent	ask
instant	now
quasi-certitude	near-certainty
s'étaient	had
sentiments	feelings
admirables	admirable
s'inclinant	bowing
regretterons	regret
personnelle	personal
diriger	direct
j'espère	I hope
successeur	successor
saura	will
empêcher	prevent
s'avança	advanced
l'ouvrit	the opened
s'inclina	bowed
faisant	making
tripotait	tripotait
attendit	waited
resta	remained
prit	took
profonde	deep
inspiration	inspiration
mots	words
voulait	wanted
suffirait	would
araignées	spiders
elles	they
indiqueraient	to indicate
bon	good
chemin	path
voilà	this is
j'arrive	I can
enfilant	threading
manteau	coat
franchir	cross
marqua	marked
pause	break
forte	strong
donne	gives
manger	eat
serai	am
claqua	slammed
enleva	removed
rauque	hoarse
feraient	would
fermer	close
dés	dice
gémir	moan
grattant	scraping
