6	6
gllderoy	gllderoy
lockhart	lockhart
le	the
lendemain	next day
en	in
revanche	contrast
harry	harry
ne	do
trouva	found
pas	not
la	the
moindre	less
occasion	opportunity
de	of
sourire	smile
les	the
choses	things
commencèrent	started
à	to
se	is
gâter	spoil
dès	as soon
petit	small
déjeuner	breakfast
dans	in
grande	great
salle	room
quatre	four
longues	long
tables	tables
une	a
pour	for
chaque	each
maison	home
débordaient	outside
porridge	porridge
harengs	herring
toasts	toast
d'œufs	eggs
au	the
plat	flat
qui	that
s'offraient	available
l'appétit	the appetite
des	of
élèves	students
sous	under
ciel	sky
magique	magic
plutôt	rather
gris	grey
et	and
couvert	covered
ce	this
jour-là	day
ron	ron
étaient	were
assis	sitting
table	table
gryffondor	gryffindor
côté	side
d'hermione	of hermione
avait	had
posé	asked
son	its
exemplaire	copy
voyages	travel
avec	with
vampires	vampires
debout	standing
contre	against
pichet	pitcher
lait	milk
pouvoir	power
lire	read
aise	comfortable
ton	your
était	was
un	a
peu	little
froid	cold
lorsqu'elle	when it
leur	their
dit	said
bonjour	hello
apparemment	apparently
elle	it
encore	yet
pardonné	forgiven
escapade	getaway
voiture	car
volante	flying
neville	neville
londubat	londubat
salua	greeted
chaleur	heat
c'était	it was
garçon	boy
visage	face
rond	round
l'air	the air
toujours	always
ahuri	bemused
il	it
d'une	a
maladresse	clumsiness
rare	rare
jamais	never
n'avait	had
rencontré	met
quelqu'un	someone
ait	has
aussi	also
mémoire	memory
courrier	mail
va	will
tarder	delay
dit-il	he said
ma	my
grand-mère	grand-mother
doit	must
m'envoyer	send me
quelques	a few
petites	small
que	that
j'ai	I
oubliées	forgotten
peine	penalty
trempé	tempered
sa	its
cuillère	spoon
qu'il	it
y	there
eut	had
soudain	suddenly
grand	great
bruit	noise
d'ailes	wings
au-dessus	above
tête	head
bonne	good
centaine	hundred
hiboux	owls
venaient	came
s'engouffrer	rush
tournoyant	spinning
laisser	let
tomber	fall
lettres	letters
paquets	packages
entre	between
mains	hands
leurs	their
destinataires	recipients
gros	wholesale
colis	package
rebondit	bounces
sur	on
instant	now
plus	more
tard	later
chose	thing
grise	grey
tomba	fell
éclaboussant	splashing
tout	all
monde	world
plumes	feathers
errol	errol
s'écria	cried
attrapant	catching
par	by
pattes	legs
hibou	owl
amorphe	amorphous
ruisselant	dripping
inanimé	inanimate
s'effondra	collapsed
ailes	wings
écartées	apart
tenait	held
bec	bec
enveloppe	envelope
rouge	red
vif	bright
oh	oh
non	not
balbutia	stammered
t'inquiète	don't worry
est	is
vivant	living
rassura	reassured
hermione	hermione
caressant	stroking
l'oiseau	the bird
du	the
bout	end
doigts	fingers
n'est	there is
ça	it
je	I
parle	speaks
regarde	look at
montrait	showed
doigt	finger
l'enveloppe	the envelope
lui	him
trouvait	was
rien	nothing
particulier	particular
mais	but
regardaient	watched
d'un	a
air	air
affolé	panic-stricken
comme	as
s'ils	if they
s'attendaient	expected
voir	see
exploser	explode
l'autre	the other
qu'est-ce	what is this
passe	pass
demanda	asked
m'a	me
envoyé	sent
beuglante	beuglante
voix	voice
faible	low
tu	you
ferais	would
mieux	better
l'ouvrir	the open
suite	suite
murmura	whispered
timidement	timidly
sinon	otherwise
sera	will be
pire	worst
m'en	me
a	has
jour	day
l'ai	I
ouverte	open
été	been
horrible	horrible
regarda	looked at
alternativement	alternatively
terrorisé	terrorized
c'est	it is
quoi	what
demanda-t-il	he asked
l'attention	attention
entièrement	fully
concentrée	concentrated
lettre	letter
laissait	left
échapper	escape
filets	nets
fumée	smoke
aux	the
coins	corners
ouvre-la	opens-the
conseilla	advised
terminé	finished
minutes	minutes
tendit	handed
main	hand
tremblante	trembling
prit	took
d'errol	of errol
l'ouvrit	the opened
boucha	busha
aussitôt	as soon
oreilles	ears
comprit	understood
pourquoi	why
moment	time
crut	believed
bel	beautiful
bien	well
explosé	exploded
rugissement	roar
féroce	fierce
retentit	sounds
l'immense	the immense
faisant	making
poussière	dust
plafond	ceiling
voler	fly
Ça	It
me	me
m'aurait	I would have
ÉtonnÉ	Surprised
qu'ils	they
te	te
renvoient	return
attends	wait
t'aie	you aie
j'imagine	I guess
t'es	you're
demandÉ	asked
quel	what
etat	state
d'inquiÉtude	anxiety
on	it
Était	Was
pÈre	father
moi	me
quand	when
vu	seen
disparu	gone
hurlements	howling
mrs	mrs
weasley	weasley
cent	cent
fois	time
puissants	powerful
d'habitude	usually
faisaient	were
trembler	shake
assiettes	plates
cuillères	spoons
répercutaient	pass
échos	echoes
assourdissants	deafening
murs	walls
pierre	stone
tous	all
s'étaient	had
tournés	shot
vers	to
eux	them
reçu	received
s'était	had
tellement	so
tassé	tassé
chaise	chair
qu'on	we
voyait	saw
front	front
écarlate	scarlet
dépasser	exceed
reÇu	received
dumbledore	dumbledore
hier	yesterday
soir	evening
cru	raw
allait	would
mourir	die
honte	shame
t'a	you
ÉlevÉ	High
pendant	during
toutes	all
ces	these
annÉes	years
conduises	ride
toi	you
vous	you
auriez	would
pu	could
tuer	kill
'	'
demandé	asked
nom	name
être	be
cité	city
essaya	tried
faire	do
s'il	if it
n'entendait	did
perçait	pierced
tympans	eardrums
absolument	absolutely
indignÉe	outraged
risque	risk
enquÊte	survey
ministÈre	department
entiÈrement	fully
ta	your
faute	fault
si	if
refais	redo
bÊtise	stupidity
reviens	come back
immÉdiatement	immediately
À	To
silence	silence
retomba	fell
imprégné	impregnated
fureur	fury
glissé	slipped
feu	fire
fut	was
rapidement	quickly
réduite	reduced
cendres	ash
semblaient	seemed to
assommés	knocked out
raz-de-marée	tidal wave
brusquement	suddenly
submergés	submerged
éclatèrent	burst
rire	laugh
conversations	conversations
reprirent	resumed
referma	closed
baissa	lowered
yeux	eyes
dont	which
sommet	summit
crâne	skull
sais	know
t'attendais	was waiting for you
dis	say
mérité	deserved
répliqua	replied
sèchement	curtly
repoussa	pushed
assiette	plate
sentiment	feeling
culpabilité	guilt
remuait	stir-fried
entrailles	bowels
mr	mr
risquait	could
l'objet	the object
enquête	survey
après	after
parents	parents
avaient	had
fait	fact
durant	during
l'été	the summer
n'eut	had
guère	little
temps	time
ruminer	mull over
davantage	more
professeur	professor
mcgonagall	mcgonagall
venue	coming
distribuer	distribute
emplois	jobs
l'année	the year
sien	his
vit	lives
allaient	would
commencer	start
cours	during
commun	common
botanique	botanical
poufsouffle	hufflepuff
quittèrent	left
ensemble	all
château	castle
traversèrent	crossed
potager	vegetable garden
dirigèrent	headed
serres	greenhouses
lesquelles	which
cultivait	cultivated
plantes	plants
magiques	magic
moins	less
eu	had
avantage	advantage
semblait	seemed
considérer	consider
suffisamment	enough
punis	punished
présent	this
amicale	friendly
qu'à	as
l'ordinaire	the ordinary
lorsqu'ils	when they
arrivèrent	arrived
devant	before
reste	rest
classe	class
déjà	already
là	there
attendant	waiting
chourave	chourave
instants	moments
traversa	crossed
pelouse	lawn
grands	great
compagnie	company
gilderoy	gilderoy
bras	arm
bandages	bandages
éprouva	felt
nouveau	new
apercevant	seeing
loin	far
saule	willow
cogneur	slugger
portait	wore
plusieurs	several
branches	branches
écharpe	scarf
petite	small
sorcière	witch
potelée	chubby
coiffée	wearing
chapeau	hat
rapiécé	patched
ses	its
cheveux	hair
désordre	disorder
vêtements	clothing
souvent	often
maculés	stained
terre	earth
l'état	the state
ongles	nails
aurait	would
s'évanouir	vanish
tante	aunt
pétunia	petunia
impeccable	impeccable
robe	dress
sorcier	sorcerer
turquoise	turquoise
dorés	golden
brillaient	shone
également	also
bordé	lined
fils	son
d'or	gold
lança	launched
adressant	sending
radieux	radiant
viens	just
montrer	show
comment	how
fallait	had to
s'y	there
prendre	take
soigner	treat
n'allez	not going to
surtout	especially
mettre	put
suis	am
meilleur	best
qu'elle	it
trouve	find
simplement	simply
genre	kind
exotiques	exotic
mes	my
serre	greenhouse
numéro	number
trois	three
aujourd'hui	today
perdu	lost
gaieté	gaiety
habituelle	usual
paraissait	seemed
très	very
mauvaise	bad
humeur	mood
murmure	whisper
ravi	ravi
jusqu'à	up to
classes	classes
déroulées	place
contenait	contained
beaucoup	a lot
intéressantes	interesting
dangereuses	dangerous
clé	key
accrochée	hung
ceinture	belt
ouvrit	opened
porte	door
respira	breathed
bouffée	puff
humide	wet
d'engrais	fertilizer
mêlée	melee
parfum	perfume
entêtant	heady
répandaient	spread
fleurs	flowers
géantes	giant
taille	size
parapluie	umbrella
pendaient	hung
s'apprêtait	was about
entrer	enter
derrière	behind
lorsque	when
posa	posa
épaule	shoulder
j'aurais	I would have
mot	word
dire	say
êtes	are
d'accord	agreement
soit	either
retard	delay
votre	your
juger	judge
mine	mine
renfrognée	scowling
n'était	there was
laissa	let
choix	choice
toute	any
façon	how
ferma	closed
nez	nose
poursuivit-il	he went on
hochant	nodding
grandes	large
dents	teeth
blanches	white
resplendissant	resplendent
soleil	sun
ah	ah
complètement	completely
désarçonné	unseated
resta	remained
silencieux	silent
entendu	heard
sûr	course
serais	would be
donné	given
gifles	slapping
savait	knew
où	where
voulait	wanted
venir	come
reprit	took
crois	believe
n'ai	haven
stupéfait	stunned
poudlard	hogwarts
compris	including
avais	had
évident	obvious
même	even
lorsqu'il	when it
parlait	spoke
l'extraordinaire	the extraordinary
faculté	faculty
d'exhiber	exhibit
étincelantes	sparkling
t'ai	you've
goût	taste
publicité	advertising
passé	past
virus	virus
as	as
journal	journal
grâce	thanks
voulu	wanted
recommencer	again
coupa	cut
saisissant	entering
l'épaule	the shoulder
comprends	understand
normal	normal
d'en	to
vouloir	want to
goûté	tasted
veux	want to
t'avoir	you have
cette	this
envie	want
pouvait	could
monter	mount
seulement	only
voilà	this is
jeune	young
homme	man
peut	can
voitures	cars
attirer	attract
dois	do
calmer	calm down
maintenant	now
auras	auras
seras	will be
âgé	old
penses	think
facile	easy
célèbre	famous
entier	integer
j'avais	I had
douze	twelve
ans	years
n'étais	there was
j'étais	I was
vague	wave
réputation	reputation
chez	in
certaines	some
personnes	people
n'est-ce	is this
cause	cause
histoire	history
celui-	the
dont-on-ne-doit-pas-prononcer-le-nom	which-one-do-must-not-pronounce-the-name
jeta	threw
coup	blow
d'oeil	eye
cicatrice	scar
glorieux	glorious
remporter	win
cinq	five
prix	price
charmeur	charmer
décerné	awarded
lectrices	readers
sorcière-hebdo	witch-hebdo
mon	my
cas	case
début	beginning
adressa	addressed
clin	clin
d'œil	eye
chaleureux	warm
avant	before
s'éloigner	away
puis	then
souvenant	remembering
censé	supposed to
suivre	follow
alla	alla
rejoindre	join
camarades	comrades
tréteaux	trestle
laquelle	which
disposés	willing
cache-oreilles	cache-ears
nous	we
allons	will
rempoter	repot
mandragores	mandrakes
annonça-t-elle	she announced
pris	taken
place	place
quelles	what
sont	are
propriétés	properties
mandragore	mandrake
personne	person
surpris	surprised
lever	sunrise
possède	has
puissantes	powerful
curatives	healing
récita-t-elle	murmured it
avalé	swallowed
manuel	manual
l'utilise	the uses
rendre	make
forme	form
d'origine	original
ou	or
santé	health
victimes	victims
métamorphoses	metamorphoses
sortilèges	spells
excellente	excellent
réponse	response
dix	ten
points	points
constitue	is
ingrédient	ingredient
essentiel	essential
entrant	incoming
composition	composition
nombreux	many
antidotes	antidotes
plante	plant
dangereuse	dangerous
leva	rose
faillit	almost
accrocher	hang
lunettes	glasses
passage	passage
cri	cry
mortel	mortal
quiconque	anyone
l'entend	the means
dit-elle	she said
exactement	exactly
occuper	care
jeunes	young
montra	showed
rangée	row
bacs	bins
rapprocha	drew
touffues	bushy
violacées	purplish
s'alignaient	lined
elles	they
n'avaient	had
remarquable	remarkable
aucune	no
idée	idea
prend	takes
paire	pair
vérifiez	check
vos	your
recouvertes	covered
ferai	will
signe	sign
levant	rising
pouce	inch
pourrez	can
enlever	remove
sans	without
alors	then
allons-y	let's go
mettez-les	put the
mit	mit
soigneusement	carefully
protégées	protected
grosses	large
boules	balls
rosés	rosé
retroussa	retroussa
manches	short
saisit	captures
l'arracha	tore it off
sec	dry
exclamation	exclamation
surprise	surprise
put	put
entendre	hear
racines	roots
espèce	species
bébé	baby
laid	ugly
plein	full
feuilles	leaves
sortaient	out
peau	skin
marbrée	marbled
couleur	color
vert	green
pâle	pale
évidence	obviously
hurlait	screaming
pleins	full
poumons	lungs
pot	pot
plongea	dove
l'enterrant	the burying
compost	compost
bientôt	soon
apparaître	appear
s'essuya	wiped his
deux	two
pouces	inches
enleva	removed
propre	own
nos	our
étant	being
stade	stage
infantile	infant
cris	cree
peuvent	can
neutre	neutral
étonnant	amazing
d'arroser	watering
bégonias	begonias
cependant	however
assommer	knock out
heures	hours
sûre	safe
parmi	among
veut	wants to
manquer	miss
première	first
journée	day
d'école	school
assurez-vous	make sure you
travaillez	work
mettez	put
bac	tray
trouverez	find
pots	pots
voudrez	want to
ici	here
là-bas	there
sacs	bags
attention	attention
tentacula	tentacula
vénéneuse	poisonous
train	train
donna	donna
épineuse	thorny
rétracta	rétracta
longs	long
tentacules	tentacles
sournoisement	slyly
glissés	dragged
furent	were
rejoints	joined
élève	student
bouclés	curly
connaissait	knew
vue	view
parlé	spoken
m'appelle	call me
justin	justin
finch-fletchley	finch-fletchley
claironnante	claironnante
serrant	tightening
es	es
potter	potter
granger	granger
meilleure	best
matières	materials
(hermione	(hermione
serra	serra
radieux)	radiant)
souvenir	remember
trouvez	find
joyeux	happy
tandis	while
remplissaient	filled
base	base
bouse	dung
dragon	dragon
type	type
formidable	great
avez	have
lu	read
livres	books
mort	death
peur	fear
coincé	stuck
cabine	cabin
téléphonique	telephone
loup-garou	loup-garou
resté	stayed
parfaitement	perfectly
calme	quiet
hop	hop
fabuleux	fabulous
normalement	normally
devais	had to
aller	go
eton	eton
collège	college
d'angleterre	of england
préfère	prefer
mère	mother
déçue	disappointed
depuis	since
ai	I
bouquins	books
commence	begins
trouver	find
utile	useful
d'avoir	to have
famille	family
ils	they
n'eurent	had
l'occasion	the opportunity
parler	talk
remis	given
exigeaient	required
l'opération	the operation
l'était	the was
n'aimaient	didn
arrachées	torn
retourner	return
tortillaient	tortillaient
sens	meaning
donnaient	gave
coups	shots
pieds	feet
brandissaient	brandished
petits	small
poings	fists
essayaient	tried
mordre	bite
fin	end
nage	swimming
membres	members
douloureux	painful
retournèrent	returned
laver	wash
dépêchèrent	dispatched
d'aller	go
métamorphose	metamorphosis
exigeante	demanding
particulièrement	particularly
difficile	difficult
appris	learned
précédente	previous
sorti	out
changer	change
scarabée	beetle
bouton	button
manteau	coat
l'animal	the animal
courait	ran
vite	fast
parvenait	could
baguette	wand
éprouvait	felt
difficultés	difficulties
essayé	tried
rafistoler	patching up
cassée	broken
papier	paper
collant	sticky
impossible	impossible
réparer	repair
lançait	launched
étincelles	sparks
dégageant	releasing
épaisse	thick
malodorante	smelly
soulagé	relieved
d'entendre	to hear
sonner	ring
sortirent	went out
seul	only
agitait	agitated
machin	machin
stupide	stupid
s'exclama-t-il	exclaimed,-t-he
ecris	write
t'en	you
achète	buy
autre	other
suggéra	suggested
mettait	put
crépiter	sizzle
d'artifice	fireworks
reçoive	receive
s'est	is
allèrent	went
retrouvèrent	found
s'empressa	hastened
boutons	buttons
impeccables	impeccable
fabriqués	manufactured
cet	this
après-midi	afternoon
précipitamment	hurriedly
détourner	divert
conversation	conversation
défense	defence
forces	forces
mal	evil
répondit	replied
entouré	surrounded
cœurs	hearts
l'emploi	employment
celle-ci	it
joues	cheeks
écarlates	scarlet
arracha	tore
cour	court
maussade	gloomy
qu'hermione	as hermione
replongeait	replongeait
parlèrent	spoke
quidditch	quidditch
sentit	felt
observé	observed
tourna	turned
clairs	clear
aperçu	overview
veille	eve
choixpeau	sorting hat
regardait	watched
fixement	staring
paralysé	paralyzed
appareil	device
photo	photo
moldu	muggle
devint	became
cramoisi	crimson
tourner	turn
colin	colin
crivey	crivey
souffle	breath
court	short
esquissant	sketching
dérangerait	mind
prenais	took
regard	look
d'espoir	hope
répéta	repeated
intrigué	intrigued
prouver	prove
enthousiasme	enthusiasm
s'approchant	approaching
près	near
raconté	told
survécu	survived
tu-sais-qui	you-know-who
copain	buddy
développe	develops
pellicule	film
potion	potion
bougera	move
vraiment	really
hein	eh
trucs	tips
bizarres	weird
savais	knew
père	father
laitier	dairy
n'y	there
croyait	believed
j'essaye	I try
photos	photos
possible	possible
envoyer	send
pouvais	could
avoir	have
serait	would be
implorant	imploring
peut-être	maybe
pourrait	could
mettrais	would
voudras	like
dédicacer	autograph
dédicacée	autographed
dédicaces	dedications
sonore	sound
cinglante	stinging
drago	drago
malefoy	malfoy
résonna	rang
arrêté	stopped
flanqué	flanked
crabbe	crabbe
goyle	goyle
amis	friends
allures	gait / movement
voyous	rogue
rang	rank
distribue	distributes
dédicacées	autographed
cantonnade	cantonnade
vrai	true
colère	anger
serrés	tight
ferme-la	farm-the
jaloux	jealous
corps	body
l'épaisseur	the thickness
cou	neck
besoin	need
crier	shout
car	because
moitié	half
présents	present
l'écoutaient	listened to it
attentivement	carefully
d'être	to be
défiguré	disfigured
suffise	suffice
trou	hole
fort	fort
autres	other
ricanaient	ricanaient
bêtement	stupidly
donc	so
manger	eat
limaces	slugs
fera	will
furieux	furious
cessa	ceased
caresser	caress
énormes	huge
menaçant	threatening
fais	do
méprisant	despising
tenir	take
tranquille	quiet
maman	mom
chercher	search
perçante	piercing
hurla	screamed
serpentard	slytherin
cinquième	fifth
année	year
s'esclaffèrent	hooted with laughter when they
bruyamment	loudly
voudrait	would like to
ironisa	ironisa
vendre	sell
cher	dear
tira	drew
poche	pocket
rafistolée	rafistolée
livre	book
claquement	banging
chuchota	whispered
j'entends	I hear
s'approcha	approached
d'eux	of them
pans	pans
flottant	floating
dédicace	dedication
voulut	wanted
quelque	some
interrompu	interrupted
épaules	shoulders
n'aurais	would have
dû	due
poser	ask
question	question
voici	here
réunis	together
immobilisé	locked
rouges	red
goguenard	bantering
double	double
portrait	portrait
rêver	dream
signerons	sign
brandit	holds up
maladroitement	awkwardly
cloche	bell
retentissait	there was a tremendous burst
signaler	report
reprise	recovery
allez	go
l'heure	the time
cria	cried
l'adresse	the address
dirigea	led
lâcher	letting go
connaître	know
formule	formula
puissante	powerful
disparaître	disappear
valait	worth
sois	am
paternel	paternal
tes	your
copains	buddies
auraient	would
cherchais	was looking for
sourd	deaf
protestations	protests
l'entraîna	the led
long	long
couloir	hallway
fit	fit
escalier	staircase
l'œil	the eye
passer	pass
conseil	council
carrière	career
raisonnable	reasonable
grosse	big
avis	notice
viendra	will come
n'en	do
ajouta-t-il	he added
arrivés	arrived
devait	should
lieu	place
lâcha	released
enfin	finally
s'asseoir	sit
fond	background
entreprit	undertook
pile	battery
éviter	avoid
auteur	author
s'assirent	sat
cuire	cook
œuf	egg
faut	must
espérer	hope
devenir	become
ginny	ginny
vont	go
fonder	based
fan-club	fan-club
entende	hear
mots	words
fan	fan
club	club
s'éclaircit	clears up
gorge	throat
randonnées	hiking
trolls	trolls
clignait	clignait
couverture	coverage
pointé	pointed
clignant	blinking
tour	tour
ordre	order
merlin	merlin
troisième	third
membre	member
honoraire	honorary
ligue	league
lauréat	winner
parlons	let's talk about
croyez-moi	believe me
réussi	successful
débarrasser	rid
spectre	spectrum
simple	simple
attendit	waited
rires	laughter
faibles	low
sourires	smiles
vois	see
acheté	bought
collection	collection
complète	complete
pensé	thought
pourrions	could
premier	first
questionnaire	questionnaire
méchant	nasty
vérifier	check
écrit	written
retenu	retained
distribua	distributed
questionnaires	questionnaires
retourna	returned
bureau	office
allez-y	go for it
demi-heure	a half-hour
répondre	reply
questions	questions
lut	lut
1)	1)
quelle	what
préférée	favorite
2)	2)
l'ambition	the ambition
secrète	secret
3)	3)
exploit	feat
réalisé	made
ainsi	as well
pages	pages
dernière	last
54)	54)
date	date
l'anniversaire	the anniversary
cadeau	gift
idéal	ideal
ramassa	picked up
copies	copies
rappelle	remember
lilas	lilac
pourtant	yet
indiqué	indicated
clairement	clearly
yéti	yeti
certains	some
d'entre	of
feraient	would
relire	read
promenades	walks
loups-garous	werewolves
j'y	I
explique	explains
chapitre	chapter
d'anniversaire	birthday
l'harmonie	harmony
hommes	men
aient	have
pouvoirs	powers
dirais	would say
m'offrait	offered me
magnum	magnum
d'ogden's	of ogden's
old	old
firewhisky	firewhisky
canaille	canaille
expression	expression
d'incrédulité	of disbelief
seamus	seamus
finnigan	finnigan
dean	dean
thomas	thomas
secoués	shaken
fou	crazy
buvait	drank
paroles	lyrics
sursauta	gasped
prononça	spoke
miss	miss
sait	knows
ambition	ambition
lancer	launch
marque	brand
produits	products
bravo	bravo
intégralement	full
copie	copy
bon	good
excellent	excellent
s'exclama	exclaimed
travail	work
pencha	bent
cage	cage
couverte	covered
morceau	song
tissu	fabric
devoir	duty
armer	arm
créatures	creatures
répugnantes	disgusting
soient	are
connues	known
sorciers	wizards
aurez	will
belles	beautiful
peurs	fears
vie	life
sachez	be aware
fâcheux	unfortunate
arriver	getting
tant	as
présence	presence
demande	request
garder	keep
malgré	despite
recouvrait	covered
cessé	stopped
recroquevillait	shrivelled
grave	serious
énerver	excited
retenaient	holding
découvrit	discovered
eh	eh
oui	yes
effet	effect
solennel	solemn
lutins	goblins
cornouaille	cornwall
fraîchement	freshly
capturés	captured
retenir	remember
éclat	glow
confondre	confused
hurlement	howl
terreur	terror
dangereux	dangerous
s'étranglant	if strangling
soyez	be
agitant	waving
l'index	the index
agacé	annoyed
parfois	sometimes
pestes	sluts
diaboliques	evil
hauts	senior
vingtaine	twenty
centimètres	centimeters
bleu	blue
électrique	electric
têtes	heads
pointues	sharp
aiguës	acute
l'impression	printing
perruches	parakeets
disputer	play
découverte	discovery
mirent	started
piailler	squeak
s'agiter	shake
tapant	typing
barreaux	bars
sortes	kinds
grimaces	funny faces
débrouiller	manage
forte	strong
charivari	charivari
indescriptible	indescribable
répandirent	spread
filant	spinning
fusées	rockets
attrapèrent	caught
soulevèrent	rose
airs	air
fracassèrent	fracassèrent
carreaux	tiles
s'enfuirent	fled
fenêtres	windows
répandant	spreading
pluie	rain
verre	glass
brisé	broken
dernier	last
quant	as
entreprirent	started
dévaster	devastate
consciencieusement	conscientiously
d'efficacité	efficiency
qu'un	a
rhinocéros	rhino
encriers	ink
renversèrent	overpowered
partout	everywhere
lacérèrent	lacérèrent
papiers	papers
arrachèrent	rent
tableaux	tables
corbeille	trash
s'emparèrent	seized
intacts	intact
jeter	throw
balançait	rocking
lustre	chandelier
attrapez-les	catch-the
voyons	see
mutinlutin	mutinlutin
malinpesti	malinpesti
aucun	no
l'un	one
fenêtre	window
étouffa	choked
évitant	avoiding
justesse	accuracy
écrasé	crushed
venait	came
sonna	rang
ruée	rush
hors	out
relatif	on
s'ensuivit	followed
releva	rose
aperçut	saw
s'apprêtaient	preparing
franchir	cross
demanderai	ask
remettre	back
ceux	those
restent	remain
sortit	went out
passant	from
bonhomme	man
rugit	roars
donnait	gave
l'oreille	the ear
travaux	work
pratiques	practices
immobilisa	immobilized
l'aide	using
enferma	locked up
essayant	trying
d'attraper	to catch
lutin	pixie
tirait	drew
langue	language
bêtises	nonsense
prodiges	wonders
accomplis	made
prétend	claims
marmonna	muttered
