17	17
l'hÉritier	the heir
de	of
serpentard	slytherin
il	it
se	is
trouvait	was
à	to
l'entrée	the entry
d'une	a
longue	long
salle	room
faiblement	low
éclairée	lit
d'immenses	huge
piliers	pillars
pierre	stone
autour	around
desquels	which
s'enroulaient	wrapping
des	of
serpents	snakes
sculptés	carved
soutenaient	supported
un	a
plafond	ceiling
noyé	drowned
dans	in
l'obscurité	the dark
et	and
projetaient	projected
leurs	their
ombres	shadows
noires	black
une	a
atmosphère	atmosphere
étrange	strange
verdâtre	greenish
le	the
cœur	heart
battant	flying
harry	harry
s'immobilisa	froze
l'oreille	the ear
tendue	tense
silence	silence
glacé	glossy
basilic	basil
était-il	was it
tapi	tapi
l'ombre	the shadow
d'un	a
pilier	pillar
où	where
ginny	ginny
sortit	went out
sa	its
baguette	wand
magique	magic
s'avança	advanced
parmi	among
les	the
colonnes	columns
chacun	each
ses	its
pas	not
répercuté	passed
en	in
écho	echo
par	by
murailles	walls
obscures	dark
gardait	kept
paupières	eyelids
peine	penalty
entrouvertes	cracked
prêt	loan
fermer	close
la	the
moindre	less
alerte	alert
a	has
plusieurs	several
reprises	times
crut	believed
voir	see
bouger	move
l'un	one
dont	which
orbites	orbits
creuses	off-peak
semblaient	seemed to
suivre	follow
mouvements	movements
lorsqu'il	when it
fut	was
arrivé	arrived
au	the
niveau	level
deux	two
derniers	last
retrouva	found
face	in the face of
statue	statue
adossée	asset-based
mur	wall
du	the
fond	background
qui	that
faisait	was
toute	any
hauteur	height
chambre	room
dut	otc
tendre	tender
cou	neck
pour	for
apercevoir	see
tête	head
elle	it
représentait	represented
sorcier	sorcerer
simiesque	monkey
avec	with
barbe	beard
mince	thin
tombait	fell
presque	almost
jusqu'au	until the
bas	the bottom
robe	dress
énormes	huge
pieds	feet
grisâtres	greyish
reposaient	based
sur	on
sol	soil
lisse	smooth
entre	between
petite	small
silhouette	silhouette
vêtue	dressed
noire	black
était	was
allongée	elongated
contre	against
terre	earth
aux	the
cheveux	hair
rouge	red
flamboyant	flamboyant
murmura	whispered
précipita	rushed
s'agenouilla	knelt down
auprès	with
d'elle	it
ne	do
sois	am
morte	dead
je	I
t'en	you
supplie	beg
jeta	threw
attrapa	caught
épaules	shoulders
retourna	returned
dos	back
son	its
visage	face
blanc	white
froid	cold
comme	as
marbre	marble
mais	but
yeux	eyes
n'étaient	there were
ouverts	open
ce	this
signifiait	meant
qu'elle	it
n'avait	had
été	been
pétrifiée	petrified
peut-être	maybe
était-elle	was it
réveille-toi	wake up
voix	voice
désespérée	desperate
secouait	shaking
ballottait	ballottait
droite	right
gauche	left
sans	without
signe	sign
vie	life
inutile	useless
réveillera	wake up
dit	said
alors	then
douce	soft
sursauta	gasped
toujours	always
genoux	knees
jeune	young
homme	man
grande	great
taille	size
noirs	black
l'observait	the observed
adossé	asset-backed
contours	contours
étaient	were
étrangement	strangely
flous	fuzzy
si	if
l'avait	had
regardé	watched
travers	through
fenêtre	window
vitres	windows
givrées	frosted
parfaitement	perfectly
reconnaissable	recognizable
tom	tom
jedusor	jedusor
approuva	approved
quitter	leave
qu'est-ce	what is this
que	that
vous	you
voulez	want to
dire	say
demanda	asked
désespéré	desperate
n'est	there is
est	is
vivante	living
répondit	replied
c'est	it is
tout	all
juste	just
l'observa	the observed
avait	had
élève	student
poudlard	hogwarts
cinquante	fifty
ans	years
auparavant	previously
pourtant	yet
là	there
devant	before
lui	him
baigné	bathed
lueur	glow
brumeuse	misty
brillait	shone
même	even
qu'il	it
seize	sixteen
êtes	are
fantôme	ghost
hésitante	hesitant
disons	let's say
plutôt	rather
souvenir	remember
paisible	peaceful
conservé	retained
pendant	during
journal	journal
intime	intimate
pointa	pointa
l'index	the index
vers	to
orteils	toes
géants	giants
petit	small
livre	book
noir	black
trouvé	found
toilettes	toilet
mimi	mimi
geignarde	whiner
ouvert	open
instant	now
comment	how
d'autres	other
soucis	worries
plus	more
urgents	urgent
faut	must
m'aider	help me
soulevant	lifting
nouveau	new
nous	we
devons	must
sortir	out
d'ici	here
vite	fast
possible	possible
y	there
cette	this
sais	know
trouve	find
peut	can
surgir	arise
moment	time
s'il	if it
plaît	please
aidez-moi	help me
fit	fit
geste	gesture
ruisselant	dripping
sueur	sweat
parvint	managed
hisser	hoist
pencha	bent
ramasser	pick up
disparu	gone
n'avez	do
vu	seen
ma	my
regardait	watched
faisant	making
tourner	turn
longs	long
doigts	fingers
merci	thank you
tendant	for
main	hand
étira	reached
lèvres	lips
sourire	smile
fixés	set
continuait	continued
faire	do
nonchalant	nonchalant
ecoutez	listen
précipitamment	hurriedly
jambes	legs
fléchies	inflected
sous	under
poids	weight
partir	from
arrive	happens
n'arrivera	not going to happen
tant	as
qu'on	we
l'aura	the aura
appelé	called
grand	great
calme	quiet
reposa	rested
incapable	unable
supporter	bear
longtemps	for a long time
demanda-t-il	he asked
donnez-moi	give me
vais	'll
peut-	can-
être	be
avoir	have
besoin	need
s'élargit	widens
non	not
tu	you
n'en	do
auras	auras
dit-il	he said
regarda	looked at
ronds	round
ça	it
veut	wants to
j'ai	I
attendu	expected
potter	potter
te	te
parler	talk
perdant	loser
patience	patience
crois	believe
comprenez	understand
très	very
bien	well
situation	situation
sommes	are
secrets	secrets
on	it
parlera	talk
tard	later
quand	when
serons	will be
sortis	out
va	will
maintenant	now
répliqua	replied
continuant	continuing
d'afficher	view
large	wide
glissa	slipped
poche	pocket
attentivement	carefully
lentement	slowly
voilà	this is
intéressante	interesting
question	question
ton	your
aimable	kind
histoire	history
raison	reason
laquelle	which
cet	this
état	state
révélé	revealed
tous	all
quelqu'un	someone
connaissait	knew
pouvait	could
quoi	what
parlez-vous	are you talking about
mon	my
écrit	written
confidences	confidences
mois	months
me	me
racontant	telling
petites	small
préoccupations	concerns
dérisoires	ridiculous
frères	brothers
moquaient	fun
arrivée	arrival
vêtements	clothing
livres	books
d'occasion	of opportunity
aussi	also
s'alluma	lit
beau	beautiful
bon	good
célèbre	famous
allait-il	was he going to
jour	day
l'aimer	love it
temps	time
quitté	left
regard	look
l'avidité	greed
terriblement	terribly
ennuyeux	boring
d'avoir	to have
entendre	hear
toutes	all
idioties	baloney
fillette	girl
onze	eleven
poursuivit-il	he went on
fait	fact
preuve	proof
ai	I
répondu	answered
compati	empathized
malheurs	woes
gentil	nice
m'adorait	adored me
personne	person
m'a	me
jamais	never
comprise	included
toi	you
m'écrivait-elle	to me, she wrote,
suis	am
heureuse	happy
pouvoir	power
confier	entrust
j'avais	I had
ami	friend
éclata	broke out
rire	laugh
aigu	acute
allait	would
donna	donna
chair	flesh
poule	hen
dois	do
reconnaître	recognize
eu	had
don	gift
séduire	seduce
gens	people
âme	soul
exactement	exactly
fallait	had to
peurs	fears
profondes	deep
obscurs	dark
donnaient	gave
force	force
senti	felt
grandir	grow
moi	me
infiniment	infinitely
celui	the
suffisant	sufficient
commencer	start
miss	miss
weasley	weasley
mes	my
propres	own
déverser	pour
peu	little
sienne	siena
signifie	means
gorge	throat
sèche	dry
n'as	did
donc	so
encore	yet
deviné	guessed
elle-même	itself
tordu	twisted
coqs	cocks
tracé	plot
terribles	terrible
messages	messages
enfin	finally
lancé	launched
monstre	monster
quatre	four
sang-de-bourbe	blood-of-mire
chatte	pussy
cracmol	cracmol
départir	dispose
oh	oh
sûr	course
début	beginning
savait	knew
c'était	it was
amusant	fun
avais	had
écrivait	wrote
intéressant	interesting
cher	dear
récita-t-il	recited to him he
horrifié	horrified
train	train
perdre	lose
mémoire	memory
plumes	feathers
coq	cock
d'où	where
elles	they
viennent	come
n'arrive	arrives
soir	evening
d'halloween	halloween
chat	cat
s'est	is
attaquer	attack
peinture	painting
percy	percy
n'arrête	never stops
pâle	pale
reconnaît	recognizes
soupçonne	suspect
autre	other
agression	aggression
aujourd'hui	today
j'étais	I was
demande	request
devenir	become
folle	crazy
l'impression	printing
attaque	attack
monde	world
serrait	tightened
poings	fists
ongles	nails
enfoncés	sunken
paumes	palms
fallu	had to
stupide	stupid
cesse	stops
confiance	trust
poursuivit	continued
fini	finished
soupçons	suspicions
essayé	tried
s'en	in
débarrasser	rid
moment-là	time
es	es
intervenu	intervened
as	as
rien	nothing
n'aurait	would
pu	could
plaisir	fun
n'importe	any
d'autre	on the other
aurait	would
tomber	fall
dessus	top
l'as	the ace
envie	want
connaître	know
pourquoi	why
vouliez-vous	did you want to
sentait	felt
trembler	shake
fureur	fury
mal	evil
égale	equal
parlé	spoken
caché	hidden
ta	your
passionnante	exciting
avide	greedy
s'attarda	lingered
cicatrice	scar
voulais	wanted
apprendre	learn
davantage	more
rencontrer	meet
gagner	win
décidé	decided
montrer	show
capture	capture
benêt	dumb
hagrid	hagrid
fois	time
empêcher	prevent
colère	anger
avez	have
tendu	tense
piège	trap
croyais	thought
s'agissait	was
simple	simple
erreur	error
parole	word
laisse	leaves
soin	care
d'imaginer	imagine
réaction	reaction
directeur	director
vieil	old
armando	armando
dippet	dippet
côté	side
pauvre	poor
brillant	brilliant
orphelin	orphan
courageux	brave
préfet	prefect
modèle	model
l'autre	the other
gros	wholesale
balourd	exciter
perd	loses
occasion	opportunity
s'attirer	attract
ennuis	trouble
élevant	raising
bébés	babies
loups-garous	werewolves
lit	bed
ou	or
allant	from
battre	beat
trolls	trolls
forêt	forest
interdite	prohibited
surpris	surprised
moi-même	myself
plan	plan
marcher	walk
facilement	easily
pensais	thought
s'apercevoir	see
l'héritier	the heir
m'avait	I had
cinq	five
années	years
entières	whole
réunir	together
informations	information
possibles	possible
découvrir	discover
passage	passage
secret	secret
permettait	allowed
d'y	there
accéder	access
l'intelligence	the intelligence
parvenir	send
seul	only
dumbledore	dumbledore
professeur	professor
métamorphose	metamorphosis
paraissait	seemed
croire	believe
innocent	innocent
réussi	successful
convaincre	convince
garder	keep
d'en	to
garde-chasse	gamekeeper
l'école	the school
quelque	some
chose	thing
semblait	seemed
autant	as much
sympathie	sympathy
autres	other
professeurs	teachers
compris	including
affaire	case
desserrer	loosen
dents	teeth
après	after
renvoi	reference
soumis	submitted
surveillance	monitoring
agaçante	annoying
désinvolte	casual
savais	knew
serait	would be
raisonnable	reasonable
d'ouvrir	open
n'avais	had
l'intention	the intention
bénéfice	earnings
longues	long
recherche	search
laisser	let
derrière	behind
conserverait	would
pages	pages
l'être	the be
qu'un	a
chance	chance
puisse	can
amener	bring
traces	traces
achever	complete
ainsi	as well
noble	noble
tâche	task
salazar	salazar
achevé	completed
air	air
triomphant	triumphant
mort	death
fois-ci	time
quelques	a few
heures	hours
philtre	potion
mandragore	mandrake
sera	will be
ceux	those
ont	have
pétrifiés	petrified
reviendront	return
t'ai	you've
reprit	took
tranquille	quiet
tuer	kill
m'intéresse	I am interested
depuis	since
nouvelle	new
cible	target
imagine	imagine
rendu	rendering
compte	account
repris	taken
tes	your
mains	hands
s'était	had
mise	update
paniquer	panic
répétait	repeated
confié	entrusted
pire	worst
révélait	revealed
idiote	silly
dortoir	dormitory
soit	either
vide	empty
venue	coming
voler	fly
restait	remained
doutais	suspected
étais	was
trace	trace
d'après	after
serais	would be
résoudre	solve
mystère	mystery
surtout	especially
meilleures	best
amies	friends
agresser	assault
tour	tour
émoi	stir
parlais	was talking about
fourchelang	fourchelang
écrire	write
propre	own
message	message
d'adieu	farewell
l'ai	I
amenée	brought
ici	here
t'attendant	you waiting for
débattue	discussed
crié	shouted
devenue	become
insupportable	unbearable
reste	rest
beaucoup	a lot
d'énergie	energy
vitale	vital
trop	too
mis	put
c'est-à-dire	that is to say,
suffisamment	enough
cas	case
permettre	allow
détacher	detach
reprendre	resume
existence	existence
autonome	stand-alone
arrivés	arrived
viendrais	come
questions	questions
poser	ask
exemple	example
lança	launched
serrés	tight
engageant	engaging
fait-il	it
bébé	baby
talent	talent
particulier	particular
ait	has
vaincre	defeat
as-tu	have you
tirer	shoot
pouvoirs	powers
voldemort	voldemort
détruits	destroyed
présent	this
rougeâtre	reddish
avides	greedy
vécu	lived
passé	past
avenir	future
écrivit	wrote
l'air	the air
lettres	letters
scintillantes	sparkling
elvis	elvis
puis	then
mouvement	movement
nom	name
s'assemblèrent	gathered themselves together
ordre	order
différent	different
lire	read
vois	see
murmura-t-il	he murmured
j'utilisais	I used
déjà	already
amis	friends
proches	close
j'allais	I was going to
accepter	accept
jeu	game
sort	fate
donné	given
immonde	foul
légué	bequeathed
moldu	muggle
père	father
mère	mother
sang	blood
coule	flows
veines	veins
conserver	keep
abject	abject
misérable	miserable
abandonné	abandoned
avant	before
naissance	birth
découvert	discovered
femme	woman
sorcière	witch
forgé	forged
viendrait	would
sorciers	wizards
auraient	would
peur	fear
prononcer	pronounce
nom-là	name
lorsque	when
devenu	now
cerveau	brain
engourdi	numb
ahuri	bemused
contemplait	contemplated
l'orphelin	the orphan
l'assassin	the assassin
parents	parents
bout	end
long	long
força	forced
raté	missed
basse	low
remplie	filled
haine	hate
sèchement	curtly
n'êtes	there are
respiration	breathing
précipitée	precipitated
désolé	sorry
décevoir	disappoint
albus	albus
d'accord	agreement
là-dessus	it
votre	your
puissance	power
osé	dared to
suite	suite
étiez	were
quel	what
lieu	place
cachez	hide
perdu	lost
repoussant	pushing
chassé	chased
château	castle
sifflante	wheezing
loin	far
pensez	think
parlant	speaking
simplement	simply
cherché	sought
souhaité	desired
vrai	true
n'y	there
croyait	believed
ouvrit	opened
bouche	mouth
figea	froze
soudain	suddenly
musique	music
venait	came
retentir	sound
déserte	deserted
s'intensifia	intensified
mélodie	melody
effrayante	scary
provoquait	caused
frissons	chills
l'échine	the spine
dressèrent	pitched
sembla	seemed
doublé	doubled
volume	volume
bientôt	soon
atteignit	reached
telle	such
intensité	intensity
vibrer	vibrate
poitrine	chest
flammes	flames
surgirent	arose
sommet	summit
proche	close
oiseau	bird
écarlate	scarlet
cygne	swan
d'apparaître	to appear
lançait	launched
chant	song
voûte	vault
queue	tail
celles	those
paon	peacock
brillaient	shone
dorée	golden
serres	greenhouses
couleur	color
d'or	gold
tenait	held
boule	ball
chiffon	cloth
l'oiseau	the bird
vola	vola
droit	right
laissa	let
posa	posa
lourdement	heavily
épaule	shoulder
bec	bec
pointu	sharp
doré	golden
petits	small
étincelants	sparkling
s'arrêta	stopped
chanter	sing
fixement	staring
chaleur	heat
joue	plays
phénix	phoenix
fixant	fixing
fumseck	fawkes
sentit	felt
presser	press
doucement	gently
vieux	old
choixpeau	sorting hat
usé	spent
rapiécé	patched
crasseux	filthy
chapeau	hat
étalé	spread
sonore	sound
l'écho	the echo
renvoyait	returns
dix	ten
personnes	people
avaient	had
ri	ri
dumbeldore	dumbeldore
t'envoie	sends you
défendre	defend
chanteur	singer
devrait	should
donner	give
courage	courage
sentir	feel
rassuré	reassured
voyait	saw
pouvaient	could
servir	serve
attendit	waited
grandissant	growing
revenons	let's go back
nos	our
affaires	business
rencontrés	met
ces	these
fois-là	time
n'ai	haven
survivre	survive
dis-le-moi	tell me
parleras	talk
ajouta-t-il	he added
resteras	tarry
vivant	living
réfléchit	thinking
allure	look
évaluant	evaluating
chances	chances
survie	survival
seraient	would be
guère	little
utiles	useful
duel	duel
n'était	there was
brillante	brilliant
s'échappait	escaped
l'heure	the time
moins	less
floue	fuzzy
solide	solid
devait	should
valait	worth
mieux	better
sait	knows
vos	your
m'avez	I have
attaqué	attacked
abrupt	steep
parce	because
sauver	save
fille	girl
ajouta-	added-
t-il	t-he
tremblant	tremblant
rage	rage
contenue	contained
empêché	prevented
vraiment	really
l'année	the year
dernière	last
débris	debris
épave	wreck
mené	led
obligé	forced
cacher	hide
tordit	twisted
grimace	grin
horrible	horrible
puissante	powerful
manière	way
conjurer	ward off
extraordinaire	extraordinary
demandais	wondering
vois-	see-
car	because
ressemblance	likeness
dû	due
remarquer	notice
avons	have
orphelins	orphans
élevés	high
moldus	muggle
probablement	probably
seuls	only
élèves	students
aient	have
lui-même	himself
physiquement	physically
ressemblons	look
finalement	finally
t'a	you
sauvé	saved
savoir	know
attendait	waiting
brandisse	brandisse
rictus	grin
leçon	lesson
allons	will
mesurer	measure
lord	lord
héritier	heir
muni	with
armes	weapons
envoyer	send
amusé	amused
s'éloigna	walked away
répandre	spread
membres	members
engourdis	numb
vit	lives
s'arrêter	stop
hauts	senior
lever	sunrise
demi	half
mit	mit
siffler	whistle
comprit	understood
disait	said
parle-moi	talk to me
accroché	hung
géant	giant
frappé	hit
d'horreur	horror
s'ouvrir	open
formant	forming
immense	huge
trou	hole
remua	stir
l'intérieur	inside
béante	gaping
sortait	out
rampant	creepy
profondeurs	depths
recula	backed
ferma	closed
caresser	caress
aile	wing
prenant	taking
envol	flight
voulu	wanted
crier	shout
façon	how
quelle	what
roi	king
lourde	heavy
masse	mass
tomba	fell
passait	passed
serpent	snake
tombé	fallen
entendit	heard
tue-le	kills-the
avançait	advanced
entendait	heard
corps	body
pesant	weighing
ramper	crawl
poussiéreux	dusty
fermées	closed
courut	ran
l'aveuglette	blindly
suivant	following
tendues	tense
trébucha	stumbled
brutalement	brutally
goût	taste
qu'à	as
mètres	meters
l'entendait	the intended
approcher	approach
eut	had
sifflement	whistle
au-dessus	above
cracher	spit
lourd	heavy
frappa	hit
projetant	projecting
s'attendait	expected
crochets	hooks
reptile	reptile
s'enfoncer	sink
sifflements	whistling
furieux	furious
frénétiques	frantic
put	put
entrouvrit	entrouvrit
assez	enough
l'énorme	the huge
vert	green
éclatant	bright
épais	thick
tronc	trunk
chêne	oak
dressé	upright
haut	top
airs	air
grosse	big
pointe	tip
oscillait	ranged
ivrogne	drunk
démarche	approach
titubante	staggering
refermer	close
détourné	hijacked
l'attention	attention
voletait	flew
essayait	tried
l'attraper	the catch
claquant	slamming
mâchoires	jaws
hérissées	bristling
fins	for
tranchants	sharp
sabres	swords
plongea	dove
disparut	disappeared
cascade	cascade
déversa	poured
s'agita	if agita
furieusement	furiously
manquant	missing
celui-ci	it
créature	creature
jaunes	yellow
globuleux	globose
crevés	punctured
ruisseler	stream
tandis	while
douleur	pain
gueule	mouth
hurla	screamed
garçon	boy
sens	meaning
odeur	smell
aveugle	blind
vacilla	wavered
désorienté	disoriented
mortel	mortal
décrire	describe
cercles	circles
angoissant	scary
donnant	giving
moments	moments
coups	shots
morts	dead
laissaient	let
échapper	escape
flots	waves
fendit	split
fouet	whip
baissa	lowered
l'éviter	avoid
plaquer	tackle
douceur	smooth
étoffe	fabric
jeté	cast
l'enfonça	pierced
aussitôt	as soon
plat	flat
ventre	belly
éviter	avoid
aide-moi	help me
pensa	thought
forces	forces
aucune	no
contracta	contracted
serré	tight
invisible	invisible
objet	object
dur	hard
l'assommant	stunning
moitié	half
etourdi	etourdi
arracha	tore
épée	sword
d'argent	money
étincelante	sparkling
apparue	appeared
poignée	handle
incrustée	keyed
rubis	ruby
œuf	egg
tue	kills
sens-le	meaning-the
relevé	statement
combattre	fight
brutal	brutal
retourner	return
s'enroula	twined himself
heurtant	hitting
s'abattit	beat down
sanglants	bloody
s'ouvrait	opened
hérissée	bristling
luisants	shiny
effilés	tapered
mortels	fatal
prêts	loans
transpercer	pierce
réussit	successful
heurta	hit
langue	language
fourchue	forked
cingla	cingla
prit	took
brandit	holds up
attaqua	attacked
visa	visa
enfonça	stuck
l'épée	the sword
jusqu'à	up to
garde	guard
transperça	pierced
palais	palace
flot	stream
tiède	warm
manche	sleeve
fulgurante	dazzling
traversa	crossed
bras	arm
coude	elbow
venimeux	venomous
enfoncé	pressed
profondément	deeply
cassa	cassa
net	net
agité	restless
convulsions	convulsions
empoigna	grabbed
crochet	hook
répandait	spread
venin	venom
l'arracha	tore it off
brûlante	hot
diffusait	broadcast
brisé	broken
imprégner	soak up
l'étoffe	the fabric
vision	vision
brouilla	brouilla
fondait	based
tourbillon	whirlpool
couleurs	colors
ternes	dull
tache	spot
passa	spent
bruissement	rustle
d'ailes	wings
pâteuse	pasty
magnifique	beautiful
posait	was
l'endroit	the place
transpercé	pierced
bruit	noise
ombre	shadow
apparaître	appear
l'a	the
pleure	crying
cligna	blink
distingua	distinguished
brouillard	fog
larmes	tears
épaisses	thick
grosses	large
perles	beads
coulaient	flowed
luisantes	shiny
m'asseoir	sit
regarder	watch
mourir	die
prends	take
pressé	hurry
somnoler	dozing
tournait	turned
finit	ends
lointaine	distant
oublié	forgot
terrassé	floored
seigneur	lord
ténèbres	darkness
sottement	foolishly
défié	challenged
rejoint	joined
chère	dear
t'aura	you will
permis	permit
vivre	live
douze	twelve
cela	this
désagréable	unpleasant
quittait	left
disparaître	disappear
réapparaître	reappear
champ	field
posé	asked
perle	pearl
formé	formed
blessure	injury
rendit	made
va-t'en	go
s'écria	cried
laisse-le	let the
releva	rose
pointait	checks
détonation	detonation
semblable	similar
coup	blow
feu	fire
vol	flight
or	gold
regardant	looking at
puissant	powerful
remède	remedy
blessures	injuries
l'avais	had
complètement	completely
reprit-il	"he said
préfère	prefer
tournoya	spun
fraction	fraction
seconde	second
levée	lifting
regardèrent	looked
réfléchir	think
hésiter	hesitation
idée	idea
hurlement	howl
perçant	piercing
terrifiant	terrifying
d'encre	ink
jaillit	springs
bouillons	broths
ruissela	poured
tordait	twisted
agitant	waving
vainement	in vain
criant	screaming
dernières	last
n'entendait	did
faible	low
régulier	regular
l'encre	the ink
couler	flow
goutte	drop
brûlant	burning
part	share
parcouru	traveled
dizaines	tens
kilomètres	kilometres
poudre	powder
cheminette	cheminette
gestes	gestures
lents	slow
ramassa	picked up
tira	drew
arracher	snatch
lame	blade
gémissement	moaning
remuait	stir-fried
redressée	straightened
assise	sitting
stupéfait	stunned
tournèrent	turned
ensuite	then
trempée	soaked
fixèrent	fixed
secouée	shaken
sanglot	sob
ruisselèrent	ruisselèrent
joues	cheeks
tau	tau
pouvais	could
jure	swear
obligée	forced
imposé	imposed
souvienne	remember
sorti	out
montrant	showing
percé	pierced
milieu	middle
n'existe	there is
ils	they
sont	are
viens	just
sortons	let's go out
renvoyée	returned
lamenta	lamented
l'aidait	helped
relever	meet
tellement	so
pourrais	could
entrer	enter
vont	go
tournoyant	spinning
entraîna	led
sinistre	disaster
enjambèrent	enjambèrent
cadavre	corpse
retournèrent	returned
tunnel	tunnel
résonnant	resonant
parois	walls
eux	them
avancèrent	forth
rapidement	quickly
entendirent	heard
sorte	so
raclement	scraping
lointain	distant
ron	ron
cria	cried
accélérant	accelerating
poussa	pushed
exclamation	exclamation
joie	joy
aperçurent	saw
surexcité	excited
creuser	dig
l'éboulis	the scree
rocs	rocks
tendit	handed
l'aider	the help
passer	pass
l'ouverture	the opening
n'osais	dared
s'exclama-t-il	exclaimed,-t-he
voulut	wanted
serrer	tighten
repoussa	pushed
sanglots	sobs
vient	comes
franchissant	crossing
aies	have
t'expliquerai	will explain
coupa	cut
pensait	thought
attendre	wait
lockhart	lockhart
là-bas	there
fort	fort
guidés	guided
grandes	large
ailes	wings
écarlates	scarlet
diffusaient	released
tuyau	hose
gilderoy	gilderoy
assis	sitting
fredonnait	hummed
chanson	song
absent	absent
sortilège	hex
d'amnésie	amnesia
marché	market
l'envers	the upside
ni	or
capable	able
débrouiller	manage
bonne	good
humeur	mood
bonjour	hello
drôle	funny
d'endroit	place
n'est-ce	is this
habitez	live
jetant	throwing
interrogateur	interrogator
examiner	review
réfléchi	thought
moyen	average
remonter	back
là-dedans	there
voleta	voleta
agitait	agitated
l'inviter	the invite
hésitant	hesitating
dirait	looks like
t'accroches	you hooks
perplexe	puzzled
ordinaire	ordinary
tenir	take
uns	each
parle	speaks
prendrez	take
ceinture	belt
saisit	captures
pan	pan
s'accrocha	clung to
dégageaient	released
devenait	became
extraordinairement	extraordinarily
léger	lightweight
s'envolaient	blew
vent	wind
s'exclamait	exclaimed
etonnant	amazing
étonnant	amazing
magie	magic
ébouriffés	tousled
frais	fees
envolée	soaring
agréable	nice
courte	short
durée	duration
retrouvèrent	found
carrelage	tile
humide	wet
lavabo	sink
dissimulait	hid
remit	gave
place	place
dit-elle	she said
déçue	disappointed
sombrement	darkly
essuyant	wiping
lunettes	glasses
maculées	stained
boue	mud
bah	bah
disais	said
j'aurais	I would have
contente	happy
partager	share
avoua	admitted
teint	complexion
argenté	silver
rougir	blush
beûrk	beûrk
lorsqu'ils	when they
eurent	had
regagné	returned
couloir	hallway
désert	desert
rivale	rival
d'humeur	mood
plaisanter	joke
continuaient	continued
inquiet	worried
sœur	sister
montra	showed
doigt	finger
entouré	surrounded
halo	halo
lumière	light
volait	flying
suivirent	followed
grands	great
minutes	minutes
bureau	office
mcgonagall	mcgonagall
porte	door
