12	12
le	the
polynectar	polynectar
professeur	professor
mcgonagall	mcgonagall
frappa	hit
à	to
la	the
porte	door
qui	that
s'ouvrit	opened
silencieusement	silently
lorsqu'ils	when they
l'eurent	had
franchie	taken
ordonna	ordered
harry	harry
de	of
l'attendre	the wait
et	and
laissa	let
seul	only
jeta	threw
un	a
coup	blow
d'oeil	eye
autour	around
lui	him
tous	all
les	the
bureaux	offices
professeurs	teachers
qu'il	it
avait	had
eu	had
l'occasion	the opportunity
visiter	visit
cette	this
année	year
celui	the
dumbledore	dumbledore
était	was
loin	far
plus	more
intéressant	interesting
s'il	if it
n'avait	had
pas	not
si	if
peur	fear
d'être	to be
renvoyé	returned
il	it
aurait	would
plaisir	fun
se	is
trouver	find
là	there
c'était	it was
une	a
belle	beautiful
grande	great
pièce	room
circulaire	circular
pleine	full
petits	small
bruits	noise
bizarres	weird
posés	posed
sur	on
des	of
tables	tables
d'étranges	strange
instruments	instruments
en	in
argent	money
bourdonnaient	buzzed
émettant	emitting
nuages	clouds
fumée	smoke
murs	walls
étaient	were
recouverts	covered
portraits	portraits
d'anciens	former
directeurs	directors
directrices	guidelines
somnolaient	somnolaient
tranquillement	quietly
dans	in
leurs	their
cadres	frames
y	there
également	also
énorme	huge
bureau	office
aux	the
pieds	feet
forme	form
serres	greenhouses
derrière	behind
étagère	shelf
chapeau	hat
pointu	sharp
usé	spent
rapiécé	patched
choixpeau	sorting hat
magique	magic
hésita	hesitated
quel	what
mal	evil
aurait-il	would it
coiffer	hair
nouvelle	new
fois	time
simplement	simply
pour	for
essayer	try
avoir	have
confirmation	confirmation
l'avait	had
bien	well
envoyé	sent
maison	home
convenait	should
contourna	rounded
sans	without
faire	do
bruit	noise
prit	took
délicatement	gently
posa	posa
doucement	gently
sa	its
tête	head
beaucoup	a lot
trop	too
grand	great
glissa	slipped
devant	before
yeux	eyes
comme	as
première	first
mis	put
plongé	immersed
noir	black
attendit	waited
petite	small
voix	voice
parla	spoke
alors	then
l'oreille	the ear
quelque	some
chose	thing
te	te
trotte	trots
dit	said
heu	uh
oui	yes
murmura	whispered
désolé	sorry
déranger	disturb
je	I
voulais	wanted
savoir	know
tu	you
demandes	applications
t'ai	you've
bonne	good
aussitôt	as soon
est	is
vrai	true
que	that
choix	choice
a	has
été	been
difficile	difficult
mais	but
maintiens	maintain
ce	this
j'ai	I
déjà	already
sentit	felt
son	its
cœur	heart
bond	bond
poitrine	chest
aurais	would have
parfaitement	perfectly
ta	your
place	place
chez	in
serpentard	slytherin
l'estomac	the stomach
contracta	contracted
attrapa	caught
par	by
pointe	tip
l'enleva	the removed
n'était	there was
qu'un	a
misérable	miserable
vieux	old
pendait	hung
entre	between
ses	its
doigts	fingers
pris	taken
d'une	a
sorte	so
nausée	nausea
reposa	rested
as	as
tort	wrong
dit-il	he said
haute	high
s'adressant	addressing
au	the
immobile	still
silencieux	silent
ne	do
bougea	moved
fit	fit
arrière	rear
regarda	looked at
étrange	strange
caquètement	chatter
d'éructation	of belching
retentit	sounds
retourna	returned
s'aperçut	saw
tout	all
debout	standing
perchoir	perch
or	gold
posé	asked
vit	lives
oiseau	bird
d'aspect	aspect
l'air	the air
dinde	turkey
moitié	half
plumée	plumée
l'oiseau	the bird
regard	look
mauvais	bad
lançant	launching
nouveau	new
l'animal	the animal
très	very
malade	sick
vitreux	glassy
tomber	fall
deux	two
plumes	feathers
situation	situation
vraiment	really
envie	want
qu'en	in
meure	die
présence	presence
peine	penalty
avait-il	had he
pensée	thought
s'embrasa	blazed up.
soudain	suddenly
jaillissement	gush
flammes	flames
échapper	escape
cri	cry
d'horreur	horror
recula	backed
cognant	bumping
contre	against
fébrilement	feverishly
quête	quest
d'un	a
verre	glass
d'eau	water
trouva	found
rien	nothing
pendant	during
temps	time
s'était	had
transformé	transformed
véritable	true
boule	ball
feu	fire
poussa	pushed
perçant	piercing
bientôt	soon
resta	remained
petit	small
tas	heap
cendres	ash
fumantes	smoking
tombées	fallen
sol	soil
du	the
entra	entered
sombre	dark
balbutia	stammered
votre	your
n'ai	haven
pu	could
surprise	surprise
sourit	smiles
moment	time
venu	come
mine	mine
épouvantable	terrible
ces	these
derniers	last
ai	I
fallait	had to
visage	face
stupéfait	stunned
glousser	squealing
rire	laugh
fumseck	fawkes
phénix	phoenix
leur	their
mort	death
s'enflamment	ignite
ils	they
renaissent	reborn
ensuite	then
regarde	look at
minuscule	tiny
oisillon	chick
fripé	crumpled
sortir	out
milieu	middle
aussi	also
laid	ugly
vieil	old
c'est	it is
dommage	damage
l'aies	the aies
vu	seen
jour	day
combustion	combustion
s'asseyant	sitting
plupart	most
joli	nice
avec	with
magnifique	beautiful
plumage	plumage
rouge	red
sont	are
créatures	creatures
fascinantes	fascinating
peuvent	can
transporter	carry
charges	expenses
lourdes	heavy
larmes	tears
ont	have
grands	great
pouvoirs	powers
guérison	healing
fidèles	faithful
spectacle	show
consumé	consumed
fait	fact
oublier	forget
raison	reason
laquelle	which
trouvait	was
revint	returned
mémoire	memory
lorsque	when
installé	installed
fauteuil	chair
directorial	directorial
perçants	piercing
avant	before
ait	has
prononcer	pronounce
moindre	less
mot	word
volée	fly
hagrid	hagrid
surgit	arises
flamboyant	flamboyant
passe-montagne	balaclava
relevé	statement
cheveux	hair
hirsutes	shaggy
tenant	taking into
toujours	always
coq	cock
main	hand
n'est	there is
ça	it
précipitamment	hurriedly
parlé	spoken
quelques	a few
secondes	seconds
qu'on	we
découvre	discover
malheureux	unhappy
garçon	boy
n'aurait	would
jamais	never
essaya	tried
dire	say
continua	continued
tempêter	rant
faisant	making
moulinets	reels
répandait	spread
peu	little
partout	everywhere
impossible	impossible
peut	can
être	be
suis	am
prêt	loan
jurer	swear
ministre	minister
magie	magic
personne	person
faut	must
coupable	guilty
sais	know
s'exclama	exclaimed
crois	believe
soit	either
l'auteur	the author
agressions	assault
ah	ah
laissant	leaving
retomber	fall
long	long
flanc	flank
cas	case
j'attendrai	I will wait for you
dehors	outside
monsieur	mr.
directeur	director
sortit	went out
embarrassé	embarrassed
vous	you
me	me
croyez	believe
demanda	asked
plein	full
d'espoir	hope
tandis	while
débarrassait	rid
non	not
veux	want to
quand	when
même	even
parler	talk
inquiet	worried
l'observait	the observed
silence	silence
mains	hands
jointes	joined
accent	emphasis
circonflexe	circumflex
voudrais	would like to
tracasse	bothering
dont	which
part	share
douce	soft
sujet	about
savait	knew
quoi	what
répondre	reply
pensa	thought
malefoy	malfoy
sera	will be
tour	tour
sang-	blood-
de-bourbe	of mire
bouillonnait	bubbled up
toilettes	toilet
mimi	mimi
geignarde	whiner
puis	then
désincarnée	disembodied
entendue	heard
reprises	times
souvint	sarah
ron	ron
entendre	hear
bon	good
signe	sign
sorciers	wizards
monde	world
disait	said
crainte	fear
grandissante	growing
lié	related
manière	way
ou	or
autre	other
salazar	salazar
répondit	replied
n'y	there
double	double
agression	aggression
justin	justin
nick	nick
quasi-sans-tête	quasi-without-head
transforma	transformed
sentiment	feeling
malaise	discomfort
régnait	reigned
jusqu'alors	until then
panique	panic
etrangement	strangely
sort	fate
semblait	seemed
inquiéter	worry
élèves	students
donc	so
pouvait	could
subir	undergo
tel	such
traitement	treatment
fantôme	ghost
demandait-on	did they
terrible	terrible
pouvoir	power
quelqu'un	someone
eut	had
ruée	rush
réservations	reservations
poudlard	hogwarts
express	express
devait	should
ramener	bring
eux	them
vacances	holiday
noël	christmas
rythme-là	pace
restera	will
nous	we
hermione	hermione
crabbe	crabbe
goyle	goyle
joyeuses	happy
perspective	perspective
faisaient	were
avaient	had
inscrit	registered
noms	names
liste	list
souhaitaient	wanted
rester	stay
château	castle
content	content
autres	other
s'en	in
aillent	go
assez	enough
voir	see
l'éviter	avoid
couloirs	corridors
s'apprêtait	was about
cracher	spit
venin	venom
d'entendre	to hear
murmurer	whisper
passage	passage
sentir	feel
cesse	stops
pointés	cleared
fred	fred
george	george
seuls	only
drôle	funny
souvent	often
s'amusaient	played
précéder	precede
lorsqu'il	when it
marchait	walked
criant	screaming
faites	do
l'héritier	the heir
attention	attention
sorcier	sorcerer
dangereux	dangerous
percy	percy
sûr	course
désapprouvait	disapproved
fermement	firmly
conduite	conduct
plaisanterie	joke
disait-il	he said
froideur	coldness
dégage	releases
répliquait	exclaimed
pressé	hurry
doit	must
rendre	make
chambre	room
secrets	secrets
prendre	take
thé	tea
serpent	snake
préféré	favorite
ajoutait	added
ginny	ginny
goûtait	tasted
arrêtez	stop
gémissait-elle	moaning-it
demandait	asked
sonore	sound
comptait	had
prochaine	next
faisait	was
semblant	pretend
vouloir	want to
écarter	aside
brandissant	waving
grosse	big
d'ail	garlic
s'offensait	if offended
facéties	jokes
rassuré	reassured
trouvaient	were
ridicule	ridiculous
puisse	can
soupçonner	suspect
revanche	contrast
farces	pranks
répétées	repeated
semblaient	seemed to
exaspérer	exasperate
drago	drago
montrait	showed
chaque	each
irrité	irritated
parce	because
brûle	burns
air	air
entendu	heard
point	point
horreur	horror
surpasse	surpasses
toi	you
attribue	assigns
horreurs	horrors
Ça	It
durera	last
longtemps	for a long time
assura	assura
ton	your
satisfait	satisfied
presque	almost
on	it
va	will
avouer	confess
vérité	truth
trimestre	quarter
termina	finished
enfin	finally
épais	thick
neige	snow
recouvrait	covered
s'abattit	beat down
n'en	do
fâché	angry
weasley	weasley
gryffondor	gryffindor
pouvaient	could
qu'ils	they
voulaient	wanted
compris	including
choisi	chosen
l'école	the school
plutôt	rather
d'aller	go
bill	bill
egypte	egypt
compagnie	company
mr	mr
mrs	mrs
passait	passed
guère	little
salle	room
commune	common
expliqué	explained
solennel	solemn
préférait	preferred
demeurer	stay
devoir	duty
tant	as
préfet	prefect
d'apporter	to make
soutien	support
période	period
troublée	troubled
matin	morning
froid	cold
blanchi	bleached
restés	stayed
dortoir	dormitory
furent	were
réveillés	woke up
heure	time
trombe	trombe
lança-t-elle	"she
forte	strong
tirant	pulling
rideaux	curtains
fenêtre	window
n'as	did
ici	here
réservé	reserved
garçons	boys
protesta	protested
protéger	protect
lumière	light
joyeux	happy
jetant	throwing
cadeau	gift
qu'elle	it
apporté	brought
levée	lifting
rajouté	added
chrysopes	lacewing
potion	potion
elle	it
prête	ready
maintenant	now
redressa	straightened
complètement	completely
réveillé	woke up
es	es
sûre	safe
absolument	absolutely
certaine	some
agir	act
dès	as soon
soir	evening
hedwige	hedwig
s'engouffra	rushed
ouverte	open
paquet	package
bec	bec
salut	hi
joyeusement	happily
posait	was
lit	bed
n'es	no es
fâchée	angry
mordilla	mordilla
affectueusement	affectionately
fut	was
précieux	precious
apportait	brought
dursley	dursley
s'agissait	was
cure-dents	toothpicks
auquel	which
ajouté	added
lettre	letter
demander	ask
serait	would be
possible	possible
passer	pass
d'été	summer
cadeaux	gifts
reçut	received
satisfaisants	satisfactory
boîte	box
caramels	caramel
envoyée	sent
livre	book
quidditch	quidditch
offert	offered
splendide	splendid
plume	pen
d'aigle	eagle
qu'hermione	as hermione
apportée	made
dernier	last
destiné	for
pull-over	pull-over
gros	wholesale
gâteau	cake
faits	facts
spécialement	specially
éprouva	felt
culpabilité	guilt
repensant	thinking back
voiture	car
volante	flying
revue	review
depuis	since
collision	collision
saule	willow
cogneur	slugger
magnifiquement	beautifully
décorée	decorated
sapins	firs
branches	branches
couvertes	covered
givre	frost
guirlandes	garlands
gui	gui
houx	holly
croisaient	crossed
au-dessus	above
têtes	heads
tiède	warm
sèche	dry
tombait	fell
plafond	ceiling
chanta	sang
cantiques	songs
repris	taken
devenait	became
tonitruante	thunderstrike
mesure	measurement
baissait	decreasing
niveau	level
pichet	pitcher
vin	wine
fini	finished
troisième	third
morceau	song
entraîna	led
hors	out
mener	lead
projet	project
devons	must
procurer	buy
bout	end
trois	three
personnes	people
allons	will
l'apparence	the appearance
dit-elle	she said
naturel	natural
envoyer	send
supermarché	supermarket
acheter	buy
lessive	laundry
transformerez	transform yourself
faudra	will
prélever	take
s'assurer	ensure
débarqueront	disembark
interrogerons	question
organisé	organized
poursuivit-elle	she continued
prêter	pay
stupéfaite	stunned
sac	bag
gâteaux	cakes
chocolat	chocolate
j'y	I
somnifère	sleeping pill
arrangez-vous	arrange
trouvent	find
chemin	path
goinfres	greedy
vont	go
sûrement	surely
dévorer	devour
seront	will be
endormis	asleep
n'aurez	will not
qu'à	as
arracher	snatch
enfermerez	enfermerez
placard	closet
puissent	can
réveil	alarm clock
échangèrent	exchanged
incrédule	incredulous
pourrait	could
tourner	turn
lança	launched
glacé	glossy
rappela	reminded
qu'avait	that was
parfois	sometimes
n'aura	will
aucun	no
effet	effect
sévère	severe
voulez	want to
interroger	question
d'accord	agreement
vas	vas
montrant	showing
flacon	bottle
contenait	contained
unique	single
cheveu	hair
souvenez	remember
ma	my
bagarre	brawl
millicent	millicent
bulstrode	bulstrode
club	club
duel	duel
laissé	left
robe	dress
essayait	tried
m'étrangler	me strangle
repartie	left
suffira	suffice
décidé	decided
revenir	return
s'occuper	care
plan	plan
où	where
choses	things
risquent	may
regardant	looking at
s'éloigner	away
pourtant	yet
partie	part
l'opération	the operation
passa	spent
facilement	easily
prévu	expected
déposé	filed
rampe	ramp
bas	the bottom
l'escalier	the stairs
attendu	expected
cachés	hidden
armure	armor
hall	hall
d'entrée	input
sortent	come out
fin	end
réveillon	new year's eve
bêtes	beasts
ravi	ravi
montra	showed
sourire	smile
niais	silly
s'emparèrent	seized
firent	did
qu'une	a
bouchée	bite
instant	now
tard	later
compte	account
arrivait	arrived
tombèrent	fell
renverse	reverses
profondément	deeply
traîner	hanging out
travers	through
jusqu'à	up to
enfermèrent	imprisoned
soigneusement	carefully
seaux	buckets
serpillières	mops
arracha	tore
front	front
autant	as much
prirent	took
chaussures	shoes
celles	those
seraient	would be
petites	small
auraient	would
taille	size
précipitèrent	ran
vers	to
chaudron	cauldron
dégageait	radiated
épaisse	thick
noire	black
bulles	bubbles
explosaient	exploded
surface	surface
avez	have
réussi	successful
ouvrant	opening
cabine	cabin
enfermée	locked
allée	alley
robes	dresses
grandes	large
lingerie	lingerie
aurez	will
besoin	need
jetèrent	cast
d'œil	eye
ressemblait	looked like
présent	this
vase	vase
paresseusement	lazily
d'avoir	to have
relisant	rereading
dernière	last
recette	recipe
passe	pass
aurons	will
bu	bu
disposerons	will
d'exactement	exactly
reprendre	resume
notre	our
normale	normal
verse	pays
verres	glasses
ajoute	adds
l'aide	using
louche	ladle
versa	versa
généreusement	generously
préparés	prepared
tremblante	trembling
l'un	one
liquide	liquid
mit	mit
siffler	whistle
bouilloire	kettle
couvrit	covered
d'écume	scum
couleur	color
jaunâtre	yellowish
passablement	fairly
répugnante	disgusting
beurk	yuck
l'extrait	the extract
mixture	mixture
dégoûté	disgusted
goût	taste
ajoutez	add
vos	your
voie	way
chacun	each
laissèrent	left
écumer	foam
kaki	khaki
teinte	hue
brunâtre	brownish
semblable	similar
boue	mud
attendez	wait
ferait	would
mieux	better
boire	drink
aura	will
tiendra	will
approuva	approved
n'a	did
séparée	separate
attentif	attentive
renverser	reverse
goutte	drop
répondirent	answered
cabines	cabins
respectives	respective
pinça	pinched
nez	nose
avala	swallowed
longues	long
gorgées	sips
chou	cabbage
cuit	cooked
entrailles	bowels
tortiller	squirming
avalé	swallowed
serpents	snakes
vivants	living
plié	folded
n'allait	did
vomir	vomit
vite	fast
sensation	sensation
brûlure	burn
répandit	spread
corps	body
ventre	belly
l'extrémité	the end
orteils	toes
l'horrible	the horrible
impression	print
fondre	melt
métal	metal
fusion	fusion
douleur	pain
terre	earth
pantelant	breathless
grandir	grow
s'épaissir	thicken
ongles	nails
s'élargir	expand
jointures	joins
saillir	mate
sous	under
peau	skin
épaules	shoulders
s'étirèrent	if étirèrent
douloureusement	painfully
démangeaison	itching
indiqua	said
poussaient	grew
augmenta	increased
volume	volume
déchirant	ripping
tonneau	barrel
éclaté	burst
devenus	become
quatre	four
subirent	suffered
supplice	torment
brusquement	suddenly
métamorphose	metamorphosis
allongé	lying
plat	flat
pierre	stone
entendait	heard
gargouillait	gurgled
tristement	sadly
l'autre	the other
débarrassa	rid
difficulté	difficulty
releva	rose
voilà	this is
ressentait	felt
ôta	took off
au-	at-
dessus	top
chevilles	ankles
revêtit	arrayed
celle	the
donnée	given
enfila	put on
grosses	large
coupés	cut
court	short
descendaient	down
rendit	made
lunettes	glasses
brouillaient	blurred my
vue	view
enleva	removed
cria	cried
rauque	hoarse
grogna	" 
d'à	to
côté	side
miroir	mirror
craquelé	cracked
face	in the face of
ternes	dull
enfoncés	sunken
orbites	orbits
gratta	scratched
l'image	the image
restèrent	stayed
contempler	contemplate
teint	complexion
pâle	pale
déboussolé	disoriented
devenu	now
exactement	exactly
coupe	cup
bol	bowl
jusqu'aux	up to
longs	long
bras	arm
gorille	gorilla
incroyable	amazing
appuyant	pressing
vérifier	check
réel	real
répéta-t-il	he kept telling her
d'y	there
aller	go
encore	yet
trouve	find
j'espère	I hope
tombera	fall
suivre	follow
attentivement	carefully
peux	can
bizarre	weird
réfléchir	think
alla	alla
frapper	hit
d'hermione	of hermione
dépêche-toi	hurry
finalement	finally
vais	'll
accompagner	accompany
aiguë	acute
allez-y	go for it
moi	me
sait	knows
laide	ugly
saura	will
vaut	worth
reste	rest
dépêchez-vous	hurry up
êtes	are
train	train
perdre	lose
décontenancé	taken aback
comprendre	understand
fois-ci	time
véritablement	truly
expression-là	expression-there
prof	prof
pose	poses
question	question
s'inquiéta	if worry
montre	watch
cinq	five
minutes	minutes
passées	past
retrouve	found
après	after
vérifié	verified
alentour	around
sortirent	went out
balance	balance
tes	your
raides	stiff
descendirent	went down
marbre	marble
restait	remained
élève	student
mène	leads
environs	surrounding area
idée	idea
basse	low
déjeuner	breakfast
viennent	come
là-bas	there
l'entrée	the entry
cachots	dungeons
fille	girl
bouclés	curly
remonta	came up
sous-sol	basement
excuse-moi	excuse me
précipitant	precipitating
oublié	forgot
retourner	return
pardon	forgiveness
sèchement	curtly
serdaigle	ravenclaw
s'éloigna	walked away
soupçonneux	suspicious
par-dessus	above
épaule	shoulder
l'obscurité	the dark
s'annonçaient	would
moins	less
faciles	easy
l'avaient	had
espéré	hoped
labyrinthe	maze
sous-sols	sub-soil
désert	desert
s'enfoncèrent	went
coups	shots
combien	how
retrouver	find
quart	quarter
d'heure	time
commençaient	started
désespérer	despair
entendirent	heard
ha	ha
silhouette	silhouette
venait	came
hâtèrent	hurried
direction	management
s'aperçurent	saw
qu'est-ce	what is this
fais	do
surpris	surprised
offensé	offended
répliqua-t-il	he replied
nom	name
n'est-ce-pas	is-this-not
hein	eh
retournez	return
prudent	careful
promener	walk
sombres	dark
temps-ci	time
remarqua	noticed
différent	different
rengorgéant	rengorgéant
risque	risk
attaquer	attack
dos	back
retournèrent	returned
virent	saw
s'avancer	advance
vie	life
traînante	shuffling
passé	past
goinfrer	stuff yourself
cherchés	searched
montrer	show
glacial	icy
sembla	seemed
outragé	outraged
ferais	would
respect	respect
envers	to
s'indigna-t-il	grew indignant-t-he
n'aime	likes
attitude	attitude
ricanement	sneer
faillit	almost
d'aimable	amiable
s'excuser	apologize
rattrapa	caught
peter	peter
commença	started
corrigea	corrected
machinalement	going through the motions
importe	any
remarqué	noticed
rôdait	was prowling
mijote	simmers
persuadé	persuaded
réussir	succeed
attraper	catch
méprisant	despising
intéressé	interested
s'arrêta	stopped
mur	wall
nu	naked
humide	wet
demanda-t-il	he asked
souviens	remember
sang-pur	pure blood
dissimulée	concealed
franchit	crosses
talons	heels
longue	long
souterraine	underground
brute	gross
lampes	lamps
rondes	round
verdâtres	greenish
suspendues	suspended
chaînes	channels
brûlait	burned
cheminée	fireplace
manteau	coat
gravé	engraved
figures	figures
compliquées	complicated
assis	sitting
près	near
fauteuils	chairs
ouvragés	crafted
attendez-moi	wait for me
vides	empty
l'écart	the gap
chercher	search
mon	my
père	father
vient	comes
l'envoyer	send
s'assirent	sat
s'efforçant	striving
décontracté	casual
instants	moments
tenait	held
coupure	cut
journal	journal
colla	colla
écarquiller	stare
stupéfaction	amazement
lut	lut
rapidement	quickly
força	forced
tendit	handed
article	article
découpé	cut
gazette	gazette
enquÊte	survey
ministÈre	department
arthur	arthur
service	service
détournements	diversions
l'artisanat	crafts
moldu	muggle
s'est	is
infliger	inflict
amende	fine
cinquante	fifty
gallions	galleons
ensorcelé	bewitched
moldue	moldue
lucius	lucius
membre	member
conseil	council
d'administration	of directors
ensorcelée	bewitched
accidentée	rugged
mois	months
demandé	asked
démission	resignation
terni	terni
réputation	reputation
ministère	department
déclaré	said
reporter	see
aucune	no
compétence	competence
rédiger	write
projets	projects
lois	laws
acte	act
protection	protection
moldus	muggle
devrait	should
immédiatement	immediately
abandonné	abandoned
refusé	refused
commentaire	comment
épouse	wife
nos	our
envoyés	sent
spéciaux	special
intérêt	interest
décamper	decamp
s'ils	if they
lâche	loose
goule	ghoul
famille	family
réjoui	pleased
aime	love
tellement	so
casser	break
baguette	wand
vivre	live
dirait	looks like
sang	blood
pur	pure
voit	see
font	do
crispé	tense
fureur	fury
t'arrive	you can
l'infirmerie	the infirmary
donne	gives
pied	foot
sang-de-bourbe	blood-of-mire
ricana	o
m'étonne	amazes me
n'ait	did
attaques	attacks
poursuivit-il	he went on
songeur	pensive
étouffer	choke
l'affaire	the case
renvoyer	return
continue	continues
nomination	appointment
pire	worst
arrivée	arrival
école	school
adore	love
enfants	children
digne	worthy
admis	admitted
rogaton	rogaton
crivey	crivey
photos	photos
appareil	device
imaginaire	imaginary
potter	potter
photo	photo
imitant	imitating
certain	some
talent	talent
autographe	autograph
lécher	lick
plaît	please
d'air	air
arrive	happens
retard	delay
forcèrent	forced
parut	appeared
lents	slow
détente	relaxation
saint	saint
l'ami	the friend
lentement	slowly
conduit	led
sinon	otherwise
traînerait	would drag
parvenue	received
granger	granger
vraie	true
celle-là	this one
pense	think
gens	people
considèrent	consider
retinrent	retained
souffle	breath
peut-être	maybe
d'avouer	to confess
seulement	only
savais	knew
mauvaise	bad
humeur	mood
pourrais	could
l'aider	the help
bouche	mouth
bée	eer
donna	donna
abruti	asshole
d'habitude	usually
heureusement	fortunately
particulier	particular
dois	do
risqua	risked
faudra-t-il	will there be a
répète	repeat
répliqua	replied
veut	wants to
ans	years
connaît	knows
toute	any
l'histoire	the story
j'attire	I draw
soupçons	suspicions
là-dessus	it
simple	simple
ajouta-t-il	he added
serra	serra
énormes	huge
poings	fists
l'inciter	encourage
calme	quiet
est-ce	is this
ouvert	open
oh	oh
connais	know
l'a	the
azkaban	azkaban
répéta	repeated
voyons	see
prison	prison
l'esprit	the spirit
lent	slow
pauvre	poor
continues	continuous
finiras	will
marcher	walk
reculons	backwards
tortilla	tortilla
impatient	looking forward
m'a	me
remarquer	notice
laisser	let
débarrasser	rid
racaille	guy
m'en	me
mêler	mix
suffisamment	enough
soucis	worries
courant	current
perquisition	search
manoir	manor
semaine	week
s'efforça	tried
donner	give
expression	expression
inquiète	concerned
eh	eh
n'ont	have
quasiment	almost
trouvé	found
possède	has
précieuses	precious
matière	material
secrète	secret
parquet	parquet
salon	living room
rougit	blushes
rougi	red
commençait	started
s'allonger	lie
l'heure	the time
écoulée	past
redevenir	again
lui-même	himself
d'après	after
horrifié	horrified
levèrent	rose
j'aille	I go
soigner	treat
estomac	stomach
ajouter	add
traversèrent	crossed
course	race
couloir	hallway
espérant	hoping
vraisemblance	likelihood
sentait	felt
glisser	drag
devenues	become
dut	otc
relever	meet
flottait	floated
montèrent	went up
arrivèrent	arrived
résonnaient	resounded
sourds	deaf
provenant	from
lequel	which
enfermé	locked
abandonnèrent	abandoned
balais	brushes
rejoindre	join
perdu	lost
refermant	closing
commis	committed
écrire	write
papa	dad
demain	tomorrow
conseiller	advisor
retrouvé	found
remit	gave
sors	go out
fichez	do not care
camp	camp
dû	due
aspect	aspect
normal	normal
apparut	appeared
traversant	crossing
cliqueter	click
verrou	lock
secouée	shaken
sanglots	sobs
caché	hidden
pan	pan
déconcerté	baffled
manquant	missing
lavabo	sink
entièrement	fully
recouvert	covered
fourrure	fur
jaunes	yellow
oreilles	ears
pointues	sharp
dépassaient	exceeded
poil	hair
chat	cat
gémit-elle	she moaned
contre-indiquée	contraindicated
métamorphoses	metamorphoses
animales	animal
aïe	ouch
moquer	fun
atroce	atrocious
grave	serious
t'emmener	take you away
madame	mrs.
pomfresh	pomfresh
questions	questions
fallut	took
convaincre	convince
accompagna	accompanied
départ	starting
moqueur	mocking
rigoler	laugh
s'apercevra	notice
queue	tail
s'exclama-t-elle	exclaimed she
ravie	happy
