13	13
un	a
journal	journal
trÈs	very
intime	intimate
hermione	hermione
resta	remained
plusieurs	several
semaines	weeks
à	to
l'infirmerie	the infirmary
lorsque	when
les	the
autres	other
élèves	students
revinrent	returned
de	of
vacances	holiday
toutes	all
sortes	kinds
rumeur	rumor
coururent	ran
sur	on
raisons	reasons
sa	its
disparition	disappearance
tout	all
le	the
monde	world
pensait	thought
qu'elle	it
avait	had
été	been
son	its
tour	tour
victime	victim
d'une	a
agression	aggression
curieux	curious
se	is
précipitaient	rushing
en	in
espérant	hoping
apercevoir	see
quelque	some
chose	thing
mais	but
madame	mrs.
pomfresh	pomfresh
entouré	surrounded
rideaux	curtains
lit	bed
d'hermione	of hermione
pour	for
lui	him
épargner	save
la	the
honte	shame
d'être	to be
vue	view
avec	with
visage	face
couvert	covered
poils	hair
harry	harry
et	and
ron	ron
venaient	came
voir	see
tous	all
soirs	night
cours	during
reprirent	resumed
ils	they
apportèrent	brought
chaque	each
jour	day
devoirs	duties
faire	do
moi	me
si	if
j'avais	I had
des	of
moustaches	whiskers
chat	cat
j'en	I
profiterais	would
arrêter	stop
travailler	work
pendant	during
que	that
je	I
suis	am
dit	said
déposant	applicant
une	a
pile	battery
livres	books
table	table
chevet	bedside
ne	do
sois	am
pas	not
stupide	stupid
répliqua	replied
vivement	strongly
il	it
faut	must
bien	well
reste	rest
au	the
niveau	level
elle	it
n'avait	had
plus	more
figure	figure
présent	this
ses	its
yeux	eyes
reprenaient	resume
peu	little
leur	their
habituelle	usual
couleur	color
marron	brown
vous	you
n'avez	do
toujours	always
rien	nothing
nouveau	new
demanda-t-elle	he asked as she
dans	in
murmure	whisper
être	be
entendue	heard
du	the
répondit	replied
d'un	a
air	air
maussade	gloomy
j'étais	I was
pourtant	yet
tellement	so
sûr	course
c'était	it was
malefoy	malfoy
centième	hundredth
fois	time
qu'est-ce	what is this
c'est	it is
ça	it
demanda	asked
montrant	showing
doré	golden
qui	that
dépassait	exceeded
sous	under
l'oreiller	the pillow
oh	oh
simple	simple
carte	card
me	me
souhaiter	wish
bon	good
rétablissement	recovery
précipitamment	hurriedly
essayant	trying
cacher	hide
fut	was
rapide	fast
saisit	captures
déplia	unfold
geste	gesture
a	has
miss	miss
granger	granger
lut-il	read it
haute	high
voix	voice
meilleurs	best
vœux	best wishes
part	share
votre	your
professeur	professor
attentif	attentive
gilderoy	gilderoy
lockhart	lockhart
ordre	order
merlin	merlin
troisième	third
classe	class
membre	member
honoraire	honorary
ligue	league
défense	defence
contre	against
forces	forces
mai	may
cinq	five
lauréat	winner
prix	price
sourire	smile
charmeur	charmer
décerné	awarded
par	by
lectrices	readers
sorcière-hebdo	witch-hebdo
jeta	threw
regard	look
dégoûté	disgusted
tu	you
dors	sor
ton	your
oreiller	pillow
sauvée	saved
apportait	brought
médicaments	drugs
évitant	avoiding
ainsi	as well
d'avoir	to have
répondre	reply
est	is
vraiment	really
type	type
baratineur	baratineur
qu'on	we
puisse	can
trouver	find
tandis	while
qu'ils	they
retournaient	return
gryffondor	gryffindor
exclamations	exclamations
fureur	fury
retentirent	rang
alors	then
l'étage	the floor
supérieur	higher
Ça	It
rusard	rusard
murmura	whispered
montèrent	went up
l'escalier	the stairs
quatre	four
cachèrent	hid
derrière	behind
angle	angle
mur	wall
écouter	listen
crois	believe
quelqu'un	someone
d'autre	on the other
s'est	is
fait	fact
attaquer	attack
tendue	tense
paraissait	seemed
fou	crazy
rage	rage
encore	yet
travail	work
l'entendirent-ils	the heard-they
hurler	scream
va	will
falloir	take
passer	pass
soirée	evening
nettoyer	clean
comme	as
n'avais	had
assez	enough
suffit	just
maintenant	now
vais	'll
dumbledore	dumbledore
s'éloignèrent	wandered up to
porte	door
claqua	slammed
passèrent	passed
tête	head
l'angle	the angle
l'endroit	the place
où	where
teigne	ringworm
attaquée	attacked
y	there
grande	great
mare	mare
d'eau	water
s'étendait	extended
moitié	half
couloir	hallway
provenait	came
apparemment	apparently
toilettes	toilet
mimi	mimi
geignarde	whiner
fini	finished
entendaient	heard
gémissements	moans
l'intérieur	inside
celle-là	this one
allons	will
traversèrent	crossed
faisant	making
attention	attention
mouiller	wet
bas	the bottom
leurs	their
robes	dresses
sorcier	sorcerer
pénétrèrent	penetrated
pleurait	crying
bruyamment	loudly
jamais	never
l'inondation	the flood
éteint	off
chandelles	candles
on	it
voyait	saw
grand-chose	much
pleurs	crying
semblaient	seemed to
provenir	come
cabine	cabin
qu'il	it
là	there
gargouilla	gargouilla
gémissante	moaning
êtes	are
venus	come
jeter	throw
s'approcha	approached
pourquoi	why
est-ce	is this
te	te
jetterait	throw
dit-il	he said
ce	this
n'est	there is
demander	ask
émergea	emerged
répandant	spreading
nouvelle	new
flaque	puddle
carrelage	tile
ici	here
tranquille	quiet
m'occuper	take care
mes	my
affaires	business
voilà	this is
s'amuse	fun
venir	come
lancer	launch
livre	book
peut	can
mal	evil
quand	when
jette	throws
traverse	crosses
fit	fit
remarquer	notice
raison	reason
n'était	there was
fallait	had to
dire	say
jetons	chips
hurla-t-elle	screamed she
aiguë	acute
toute	any
façon	how
sentira	feel
dix	ten
points	points
passe	pass
travers	through
ventre	belly
cinquante	fifty
s'il	if it
ha	ha
rit	laughs
très	very
drôle	funny
jeu	game
t'a	you
jeté	cast
n'en	do
sais	know
tranquillement	quietly
assise	sitting
tuyau	hose
pensant	thinking
mort	death
m'est	I
tombé	fallen
dessus	top
là-bas	there
virent	saw
lavabo	sink
petit	small
couverture	coverage
noire	black
miteuse	shabby
aussi	also
trempé	tempered
pencha	bent
ramasser	pick up
l'en	the
empêcha	prevented
prend	takes
s'étonna	was surprised
es	es
dangereux	dangerous
éclatant	bright
rire	laugh
plaisantes	pleasant
avoir	have
peux	can
savoir	know
trouve	find
parfois	sometimes
papa	dad
m'a	me
raconté	told
qu'un	a
ministère	department
confisqué	confiscated
pouvoir	power
rendre	make
lecteur	drive
aveugle	blind
n'as	did
entendu	heard
parler	talk
sonnets	sonnets
celui	the
lisait	read
était	was
condamné	sentenced
vers	to
jours	days
même	even
pouvait	could
s'arrêter	stop
lire	read
mis	put
nez	nose
dedans	in
seule	only
main	hand
sans	without
quitter	leave
d'accord	agreement
j'ai	I
compris	including
noir	black
imbibé	soaked
particulier	particular
mieux	better
d'y	there
coup	blow
d'œil	eye
verra	see
arrivera	will
ramassant	picking up
vit	lives
suite	suite
s'agissait	was
d'après	after
date	date
arrivait	arrived
vieux	old
ans	years
l'ouvrit	the opened
avidité	greed
première	first
page	page
portait	wore
nom	name
tracé	plot
encre	ink
bavé	drooled
t	t
e	e
jedusor	jedusor
attends	wait
par-dessus	above
l'épaule	the shoulder
connais	know
récompensé	rewarded
services	services
rendus	rendered
l'école	the school
comment	how
étonné	surprised
parce	because
ma	my
retenue	withholding
astiquer	Polish
l'écusson	the crest
reçu	received
récompense	reward
amer	bitter
avais	had
passé	past
heure	time
frotter	rub
gravé	engraved
métal	metal
t'en	you
souviendrais	remember
tourna	turned
précaution	caution
pages	pages
mouillées	wet
elles	they
étaient	were
entièrement	fully
vierges	virgin
n'y	there
trouva	found
moindre	less
ligne	line
rendez-vous	appointment
ou	or
d'anniversaire	birthday
rappeler	remember
n'a	did
écrit	written
là-dedans	there
déçu	disappointed
demande	request
voulu	wanted
s'en	in
débarrasser	rid
jetant	throwing
intrigué	intrigued
dos	back
papetier	paper
vauxhall	vauxhall
road	road
londres	london
type-là	type-there
devait	should
famille	family
moldus	muggle
songeur	pensive
acheté	bought
cas	case
servir	serve
baissa	lowered
jettes	throw
préféra	preferred
mettre	put
poche	pocket
début	beginning
mois	months
février	February
débarrassée	free
fourrure	fur
queue	tail
quitta	left
enfin	finally
dès	as soon
retour	return
montra	showed
carnet	book
raconta	told
l'avaient	had
trouvé	found
peut-être	maybe
pouvoirs	powers
cachés	hidden
enthousiaste	enthusiastic
examinant	examining
près	near
doivent	must
devenu	now
timide	shy
ferais	would
m'intéresse	I am interested
justement	precisely
essayé	tried
j'aimerais	I would like to
quel	what
genre	kind
service	service
rendu	rendering
poudlard	hogwarts
recevoir	receive
élève	student
exceptionnel	exceptional
sauvé	saved
poulpe	octopus
géant	giant
assassiné	murdered
grand	great
communauté	community
observant	observing
comprit	understood
regardait	watched
alternativement	alternatively
interrogateur	interrogator
chambre	room
secrets	secrets
ouverte	open
non	not
nous	we
l'a	the
révélé	revealed
oui	yes
or	gold
d'il	it
ajouta	added
surexcitée	horny
réveille-toi	wake up
s'impatienta	got annoyed
sait	knows
ouvert	open
renvoyé	returned
obtenu	obtained
cette	this
démasqué	unmasked
l'héritier	the heir
serpentard	slytherin
permettrait	would
doute	doubt
l'emplacement	the location
l'ouvrir	the open
créature	creature
enfermé	locked
l'auteur	the author
agressions	assault
actuelles	current
n'aurait	would
intérêt	interest
tel	such
traîne	trolling
n'importe	any
magnifique	beautiful
raisonnement	reasoning
juste	just
défaut	default
d'écrit	written
sortit	went out
baguette	wand
magique	magic
sac	bag
l'encre	the ink
invisible	invisible
murmura-t-elle	she whispered
tapota	tapped
trois	three
prononçant	speaking
formule	formula
aparecium	aparecium
produsit	produsit
découragée	discouraged
autant	as much
fouilla	fumbled
retira	retired
espèce	species
grosse	big
gomme	gum
rouge	red
vif	bright
révélateur	developer
expliqua-t-elle	explained it
l'ai	I
magasin	store
chemin	path
frotta	rubbed
vigoureusement	vigorously
premier	first
janvier	January
produisit	produced
dis	say
trouvera	find
commenta	commented
dû	due
cadeau	gift
noël	christmas
écrire	write
eu	had
envie	want
su	su
sachant	knowing
contenait	contained
cessait	stopped
d'en	to
tourner	turn
distrait	distracted
machinalement	going through the motions
histoire	history
semblait	seemed
signifier	mean
ami	friend
petite	small
enfance	childhood
oublié	forgot
depuis	since
absurde	absurd
cependant	however
d'amis	friends
avant	before
d'arriver	to arrive
dudley	dudley
décidé	decided
lendemain	next day
matin	morning
bonne	good
rendit	made
salle	room
trophées	trophies
examiner	review
offert	offered
guise	as
trouvait	was
l'idée	the idea
excellente	excellent
beaucoup	a lot
moins	less
convaincu	convinced
répéter	repeat
vu	seen
vie	life
rangé	tidy
armoire	wardrobe
faisait	was
coin	corner
l'inscription	the registration
n'indiquait	did
quelle	what
trouvèrent	found
vieille	old
médaille	medal
mérite	merit
liste	list
d'anciens	former
préfets-en-chef	prefects-in-chief
percy	percy
fronçant	frowned
préfet-en-chef	prefect-in-chief
j'imagine	I guess
vois	see
vexée	huffy
soleil	sun
recommençait	started
briller	shine
timidement	timidly
château	castle
l'humeur	the mood
morose	gloomy
celle	the
dont	which
justin	justin
nick	nick
quasi-sans-tête	quasi-without-head
avaient	had
victimes	victims
chourave	chourave
annonça	announced
réjoui	pleased
racines	roots
mandragore	mandrake
devenaient	became
grincheuses	grumpy
renfermées	contained
signifiait	meant
qu'elles	they
grandi	grew up
n'auront	there will be
d'acné	acne
pourra	may
rempoter	repot
dit-elle	she said
après	after
couperons	pull
ferons	will
macérer	soak
retrouvera	find
vite	fast
santé	health
prendre	take
peur	fear
pensa	thought
état	state
d'alerte	alert
devenait	became
risqué	risky
d'ouvrir	open
monstre	monster
s'était	had
résolu	resolved
hiberner	hibernate
demi-siècle	a half-century
ernie	ernie
macmillan	macmillan
l'élève	the student
poufsouffle	hufflepuff
partageait	shared
vision	vision
optimiste	optimistic
coupable	guilty
trahi	betrayed
soir	evening
club	club
duel	duel
peeves	peeves
n'arrangeait	not suited
pris	taken
l'habitude	the usual
surgir	arise
couloirs	corridors
chantonnant	humming
potter	potter
vipère	viper
exécutait	running
quelques	a few
figures	figures
danse	dance
compléter	complete
spectacle	show
persuadé	persuaded
cesser	stop
l'avait	had
mcgonagall	mcgonagall
attendaient	waiting
rang	rank
devant	before
lieu	place
métamorphose	metamorphosis
pense	think
passera	will
minerva	minerva
avait-il	had he
affirmé	said
tapotant	tapping
bout	end
fermée	closed
temps	time
comprendre	understand
mettrais	would
longtemps	for a long time
démasquer	unmask
valait	worth
s'arrête	stops
m'en	me
mêle	mixes
sérieusement	seriously
faudrait	should
remonte	back
moral	moral
fasse	do
oublier	forget
mauvais	bad
souvenirs	memories
dernier	last
trimestre	quarter
l'instant	the moment
idée	idea
tapoté	tapped
s'éloigner	away
grands	great
déjeuner	breakfast
quatorze	fourteen
découvrit	discovered
remonter	back
arrivé	arrived
retard	delay
crut	believed
d'abord	first
trompé	wrong
murs	walls
recouverts	covered
grosses	large
fleurs	flowers
rosé	rosé
confetti	confetti
forme	form
cœur	heart
tombaient	fell
plafond	ceiling
bleu	blue
pâle	pale
assis	sitting
l'air	the air
écœuré	sickened
qu'hermione	as hermione
pouffait	pouffait
s'asseyant	sitting
côté	side
d'eux	of them
trop	too
consterné	appalled
doigt	finger
professeurs	teachers
vêtu	dressed
robe	dress
signe	sign
silence	silence
côtés	sides
gardaient	kept
marbre	marble
joyeuse	joyful
saint-valentin	valentine's day
s'écria	cried
voudrais	would like to
commencer	start
remercier	thank
quarante-	forty-
six	six
personnes	people
m'ont	I have
envoyé	sent
occasion	opportunity
voyez	see
liberté	freedom
surprise	surprise
tapa	tapa
mains	hands
douzaine	dozen
nains	dwarves
grincheux	grumpy
entrèrent	went
affublés	decked out
d'ailes	wings
dorées	golden
tenaient	held
chacun	each
harpe	harp
entre	between
voici	here
cupidons	cupidons
porteurs	holders
messages	messages
eux	them
seront	will be
chargés	loaded
long	long
journée	day
transmettre	pass
dis-moi	tell me
fais	do
partie	part
quarante-six	forty-six
imbéciles	fools
ont	have
lorsqu'ils	when they
quittèrent	left
sembla	seemed
soudain	suddenly
absorbée	absorbed
contenu	content
oublia	forgot
sillonnèrent	sillonnèrent
classes	classes
délivrer	issue
agacement	annoyance
fin	end
l'après-midi	in the afternoon
changeaient	changed
aller	go
sortilèges	spells
l'un	one
sinistre	disaster
douze	twelve
courut	ran
toi	you
cria-t-il	he shouted
donnant	giving
coups	shots
coude	elbow
écarter	aside
essaya	tried
s'esquiver	if dodge
nain	dwarf
parvint	managed
rattraper	catch up
message	message
musical	music
personne	person
brandissant	waving
menaçant	threatening
protesta	protested
tentait	tried
s'échapper	escape
grogna	" 
attrapa	caught
tira	drew
ramener	bring
arrière	rear
laissez-moi	let me
lança	launched
dégager	release
bruit	noise
déchirure	tear
s'ouvrit	opened
deux	two
déversant	pouring
sol	soil
parchemins	scrolls
plumes	feathers
couronner	top
bouteille	bottle
d'encre	ink
brisa	broke
chute	fall
répandit	spread
s'efforça	tried
mette	mette
chanter	sing
traînante	shuffling
drago	drago
gestes	gestures
fébriles	febrile
fourra	stuffed
déchiré	torn
désespérément	desperately
s'enfuir	escape
n'entende	heard
destiné	for
chahut	ruckus
familière	familiar
lieux	places
paniqué	panicked
voulut	wanted
jambes	legs
cou	neck
genoux	knees
plaqua	wood, and overlaid
tiens	want
chevilles	ankles
chanté	sung
sont	are
verts	green
crapaud	toad
frais	fees
cheveux	hair
noirs	black
corbeau	raven
divin	divine
mon	my
héros	hero
roi	king
tant	as
soit	either
combattu	fought
vaincu	defeated
seigneur	lord
ténèbres	darkness
nues	naked
aurait	would
volontiers	happy
donné	given
l'or	gold
gringotts	gringotts
disparaître	disappear
s'efforçant	striving
vaillamment	valiantly
releva	rose
disperser	disperse
foule	crowd
certains	some
pleuraient	crying
ramassa	picked up
trouvaille	find
crabbe	crabbe
goyle	goyle
compte	account
rends-moi	give me
s'énerver	get excited
remarqué	noticed
inscrite	registered
tomba	fell
ginny	ginny
terrifiée	terrified
rends-lui	give him
sévère	severe
regardé	watched
préfet	prefect
commença	started
perdu	lost
patience	patience
expelliarmus	expelliarmus
s'exclama-t-il	exclaimed,-t-he
sortant	outgoing
s'envola	flew
aussitôt	as soon
rattrapa	caught
interdit	prohibited
pratiquer	practice
magie	magic
obligé	forced
rapport	report
content	content
marqué	marked
point	point
soucier	worry about
conséquences	consequences
furieux	furious
passa	spent
entrer	enter
méprisant	despising
apprécié	appreciated
cacha	hid
précipita	rushed
grognement	grunt
arrêta	stopped
inutile	useless
vomir	vomit
limaces	slugs
suivant	following
remarqua	noticed
d'étrange	strange
tachés	stained
répandue	widespread
tombant	falling
sauf	except
immaculées	pristine
qu'auparavant	as before
également	also
coulé	cast
montrer	show
phénomène	phenomenon
celui-ci	it
ennuis	trouble
laissait	left
échapper	escape
bulles	bubbles
violettes	purple
d'humeur	mood
préoccuper	concern
soir-là	evening
alla	alla
coucher	bedroom
supportait	supported
d'entendre	to hear
fred	fred
george	george
cesse	stops
baldaquin	canopy
prit	took
plume	pen
encrier	inkwell
laissa	let
tomber	fall
goutte	drop
instant	now
tache	spot
brilla	shone
puis	then
disparut	disappeared
aspirée	sucked
papier	paper
fébrile	febrile
reprit	took
écrivit	wrote
m'appelle	call me
mots	words
tracés	paths
brillèrent	flashed
disparurent	disappeared
tard	later
d'autres	other
lettres	letters
formèrent	formed
suintaient	leaked
phrase	sentence
suivante	following
écrite	written
apparut	appeared
bonjour	hello
tom	tom
as-tu	have you
ces	these
eut	had
d'écrire	write
attendit	waited
impatience	impatience
réponse	response
tarda	soon
apparaître	appear
heureusement	fortunately
consigné	logged
durable	sustainable
certaines	some
feraient	would
lu	read
voulez-vous	do you want to
écriture	writing
tremblante	trembling
d'excitation	excitation
veux	want to
contient	contains
souvenir	remember
d'événements	events
horribles	horrible
produits	products
collège	college
restés	stayed
événements	events
train	train
produire	produce
savez-vous	do you know
attendre	wait
devenue	become
précipitée	precipitated
voulait	wanted
dépêcher	hurry
savait	knew
époque	time
disait	said
légende	legend
n'existait	there was
mensonge	lie
cinquième	fifth
année	year
attaqué	attacked
tuer	kill
réussi	successful
dippet	dippet
directeur	director
temps-là	time
révéler	reveal
vérité	truth
fille	girl
morte	dead
tuée	killed
accident	accident
inexplicable	inexplicable
ensuite	then
bel	beautiful
écusson	crest
récompenser	reward
m'ordonnant	me ordering
savais	knew
drame	drama
vivant	living
libérer	free
prison	prison
faillit	almost
renverser	reverse
semble	seems
responsable	responsible
dernière	last
verras	see
toi-même	yourself
croire	believe
parole	word
t'emmener	take you away
surpris	surprised
hésita	hesitated
était-il	was it
possible	possible
d'emmener	take
anxieux	anxiety
dortoir	dormitory
lorsqu'il	when it
regarda	looked at
montre	watch
fraction	fraction
seconde	second
o	o
k	k
mirent	started
seules	only
l'action	the action
rafale	burst
vent	wind
s'immobilisèrent	if immobilisèrent
treize	thirteen
juin	June
case	check
laquelle	which
transforma	transformed
sorte	so
minuscule	tiny
écran	screen
télévision	tv
tremblantes	trembling
approcha	approached
coller	paste
œil	eye
fenêtre	window
sentit	felt
basculer	switch
s'élargissait	expanded
plongeait	dove
ouverture	opening
emporté	away
tourbillon	whirlpool
d'ombres	shadows
couleurs	colors
bientôt	soon
dur	hard
pieds	feet
tremblant	tremblant
corps	body
formes	forms
floues	fuzzy
retrouvèrent	found
brusquement	suddenly
netteté	sharpness
objectif	objective
reconnut	recognized
immédiatement	immediately
lequel	which
pièce	room
ronde	round
aux	the
portraits	portraits
somnolents	sleepy
bureau	office
l'homme	the man
ridé	corrugated
frêle	frail
chauve	bald
rares	rare
blancs	white
fins	for
eclairé	lit
chandelle	candle
lettre	letter
cet	this
homme	man
désolé	sorry
assurée	insured
voulais	wanted
déranger	disturb
accorda	granted
continuait	continued
sourcils	eyebrows
légèrement	slightly
froncés	a frown
vaut	worth
aille	go
balbutia-t-il	stammered out there
continua	continued
replia	flexed
leva	rose
fauteuil	chair
ouvrir	open
dehors	outside
ciel	sky
couchait	set
retourna	returned
rassit	stales
pouces	inches
fixés	set
autour	around
ni	or
fumseck	fawkes
phénix	phoenix
étranges	strange
instruments	instruments
entendus	heard
bourdonner	buzz
connu	known
exercice	exercise
l'époque	the time
fantôme	ghost
gens	people
pouvaient	could
frappa	hit
entrez	enter
faible	low
garçon	boy
environ	about
seize	sixteen
poussa	pushed
ôta	took off
chapeau	hat
pointu	sharp
insigne	badge
brillait	shone
poitrine	chest
jais	jet
ah	ah
vouliez	want to
l'aise	comfortable
asseyez-vous	sit
viens	just
m'avez	I have
envoyée	sent
s'assit	sat
étroitement	closely
serrées	tight
l'une	one
l'autre	the other
bienveillant	benevolent
impossible	impossible
autoriser	allow
rester	stay
l'été	the summer
voulez	want to
rentrer	return
chez	in
préfère	prefer
plutôt	rather
retourner	return
habitez	live
orphelinat	orphanage
intéressé	interested
monsieur	mr.
rougissant	blushing
né	born
parents	parents
père	father
moldu	muggle
mère	mother
sorcière	witch
vos	your
naissance	birth
l'orphelinat	the orphanage
vécu	lived
choisir	choose
prénoms	first names
prénom	first name
elvis	elvis
grand-père	grand-father
hocha	hocha
compatissant	compassionate
normalement	normally
pu	could
s'arranger	arrange
garder	keep
circonstances	circumstances
présentes	these
bond	bond
manquer	miss
cela	this
effet	effect
devez	must
serait	would be
déraisonnable	unreasonable
tenu	view
récente	recent
tragédie	tragedy
malheureuse	unfortunate
jeune	young
serez	will be
sécurité	security
envisage	plans
fermer	close
n'avons	have
malheureusement	unfortunately
situait	was
heu	uh
source	source
désagréments	inconvenience
lueur	glow
terminé	finished
redressant	straightening
sauriez-vous	would you know
concernant	on
lui-même	himself
répondu	answered
retomber	fall
pouvez	can
sortir	out
emboîta	emboîta
descendirent	went down
colimaçon	spiral
sortirent	went out
gargouille	gargoyle
s'arrêta	stopped
l'observa	the observed
front	front
plissé	pleated
lèvres	lips
réfléchissait	thinking
décision	decision
s'éloigna	walked away
suivi	follow-up
eurent	had
atteint	reached
hall	hall
d'entrée	input
taille	size
longue	long
barbe	beard
châtain-roux	chestnut-red
appela	called
faites-vous	do you
promener	walk
bouche	mouth
bée	eer
allé	gone
dépêchez-vous	hurry up
d'aller	go
regards	looks
pénétrants	penetrating
connaissait	knew
traîner	hanging out
profond	deep
soupir	sigh
souhaita	wished
nuit	night
ait	has
disparu	gone
dirigea	led
descendait	down
cachots	dungeons
talons	heels
contrairement	unlike
espérait	hoped
conduisit	led
passage	passage
secret	secret
rogue	rogue
donnait	gave
potion	potion
torches	torches
n'étaient	there were
allumées	lit
referma	closed
laissant	leaving
entrebâillée	ajar
silhouette	silhouette
immobile	still
surveillait	watching
l'œil	the eye
collé	stuck
l'ouverture	the opening
l'impression	printing
produise	happen
commençait	started
bougea	moved
avançait	advanced
cachot	dungeon
l'affût	the lookout
silencieux	silent
ombre	shadow
écarta	separated
glissa	slipped
l'entrebâillement	round
suivit	followed
l'inconnu	the unknown
marchait	walked
pointe	tip
oubliant	forgetting
l'entendre	hear
minutes	minutes
suivirent	followed
bruits	noise
résonnaient	resounded
loin	far
s'immobilisa	froze
l'oreille	the ear
entendit	heard
grincer	squeak
rauque	hoarse
allez	go
boîte	box
parut	appeared
oreilles	ears
sombre	dark
massive	massive
accroupi	crouching
posée	asked
bonsoir	hello
rubeus	redglow
fiches	sheets
dénoncer	denounce
veulent	want to
continuent	continue
l'intention	the intention
monstres	monsters
faciles	easy
domestiquer	domesticate
as	as
laisser	let
dégourdir	stretch
n'ai	haven
tué	killed
panneau	panel
entendait	heard
bruissement	rustle
accompagné	accompanied
cliquetis	rattling
s'approchant	approaching
vont	go
arriver	getting
demain	tomorrow
d'abattre	shoot
rugit	roars
ecarte-toi	rejected-you
ordonna	ordered
jaillir	squirt
flamme	flame
aveuglante	blinding
illumina	illumina
telle	such
force	force
projeta	projected
l'encadrement	coaching
arracha	tore
hurlement	howl
perçant	piercing
seul	only
put	put
entendre	hear
hérissé	spiky
enchevêtrement	tangle
pattes	legs
noires	black
innombrables	countless
brillaient	shone
l'obscurité	the dark
paire	pair
pinces	pliers
aiguisées	sharp
rasoir	razor
s'enfuit	fled
terre	earth
fila	fila
brandit	holds up
sauta	jumped
hurlant	screaming
noooooooooon	noooooooooon
mit	mit
devint	became
totale	total
gouffre	abyss
retrouva	found
allongé	lying
bras	arm
croix	cross
reprendre	resume
souffle	breath
entra	entered
redressa	straightened
sueur	sweat
s'inquiéta	if worry
hagrid	hagrid
