11	11
le	the
club	club
de	of
duel	duel
lorsque	when
harry	harry
se	is
réveilla	woke up
dimanche	Sunday
matin	morning
la	the
salle	room
l'infirmerie	the infirmary
était	was
baignée	bathed
d'un	a
soleil	sun
d'hiver	winter
étincelant	sparkling
ses	its
os	os
avaient	had
repoussé	pushed
mais	but
son	its
bras	arm
terriblement	terribly
raide	stiff
il	it
redressa	straightened
et	and
jeta	threw
un	a
coup	blow
d'oeil	eye
en	in
direction	management
du	the
corps	body
pétrifié	petrified
colin	colin
rideau	curtain
tendu	tense
autour	around
lit	bed
l'empêchait	the prevented
voir	see
quoi	what
que	that
ce	this
soit	either
voyant	light
qu'il	it
réveillé	woke up
madame	mrs.
pomfresh	pomfresh
entra	entered
avec	with
plateau	tea
petit	small
déjeuner	breakfast
commença	started
à	to
masser	massage
plier	fold
étirer	stretch
doigts	fingers
aux	the
tout	all
neufs	new
est	is
ordre	order
dit-elle	she said
quand	when
tu	you
auras	auras
fini	finished
manger	eat
pourras	can
t'en	you
aller	go
s'habilla	dressed
plus	more
vite	fast
possible	possible
hâta	haste
retourner	return
dans	in
tour	tour
gryffondor	gryffindor
pour	for
raconter	tell
ron	ron
hermione	hermione
qui	that
s'était	had
passé	past
pendant	during
nuit	night
ils	they
n'étaient	there were
pas	not
là	there
partit	left
leur	their
recherche	search
peu	little
peiné	pained
qu'ils	they
ne	do
manifestent	show
d'intérêt	interest
l'état	the state
passant	from
devant	before
bibliothèque	library
croisa	crossed
percy	percy
weasley	weasley
sortait	out
semblait	seemed
bien	well
meilleure	best
humeur	mood
dernière	last
fois	time
s'étaient	had
rencontrés	met
salut	hi
dit-il	he said
très	very
joli	nice
hier	yesterday
vraiment	really
remarquable	remarkable
prend	takes
tête	head
coupe	cup
des	of
quatre	four
maisons	houses
grâce	thanks
toi	you
nous	we
avons	have
cinquante	fifty
points	points
d'avance	advance
n'aurais	would have
vu	seen
demanda	asked
non	not
répondit	replied
sourire	smile
s'effaça	vanished
j'espère	I hope
n'est	there is
encore	yet
toilettes	toilet
filles	girls
ajouta-t-il	he added
eut	had
rire	laugh
forcé	forced
attendit	waited
ait	has
disparu	gone
au	the
bout	end
couloir	hallway
avant	before
prendre	take
mimi	mimi
geignarde	whiner
voyait	saw
pourquoi	why
y	there
seraient	would be
retournés	returned
lorsqu'il	when it
ouvrit	opened
porte	door
entendit	heard
leurs	their
voix	voice
provenaient	came
d'une	a
cabine	cabin
fermée	closed
clé	key
c'est	it is
moi	me
refermant	closing
derrière	behind
lui	him
bruit	noise
métal	metal
d'éclaboussures	splash
une	a
exclamation	exclamation
étouffée	choked
puis	then
vit	lives
apparaître	appear
l'œil	the eye
d'hermione	of hermione
travers	through
trou	hole
serrure	lock
dit	said
ouvrant	opening
as	as
fichu	damn
ces	these
frousses	frousses
entre	between
comment	how
va	will
ton	your
a	has
merveille	wonder
répondit-il	he replied
faufilant	weaving
vieux	old
chaudron	cauldron
posé	asked
sur	on
cuvette	bowl
juger	judge
par	by
crépitement	crackling
qu'on	we
entendait	heard
feu	fire
brûlait	burned
au-dessous	below
allumer	turn on
feux	lights
magiques	magic
pouvait	could
transporter	carry
faire	do
brûler	burn
n'importe	any
où	where
compris	including
endroits	places
humides	wet
grandes	large
spécialités	specialties
on	it
voulait	wanted
venir	come
te	te
décidé	decided
commencer	start
suite	suite
fabrication	manufacturing
polynectar	polynectar
expliqua	explained
tandis	while
refermait	closing
difficulté	difficulty
pensé	thought
c'était	it was
ici	here
cachette	cache
arrivé	arrived
l'interrompit	the interrupted
déjà	already
courant	current
entendu	heard
professeur	professor
mcgonagall	mcgonagall
flitwick	flitwick
ça	it
voulu	wanted
dépêcher	hurry
obtiendra	get
confession	confession
malefoy	malfoy
mieux	better
vaudra	worth
grogna	" 
sais	know
je	I
pense	think
tellement	so
furieux	furious
après	after
match	match
quidditch	quidditch
s'est	is
vengé	avenged
autre	other
chose	thing
regardant	looking at
jeter	throw
touffes	tufts
polygonum	polygonum
dobby	dobby
venu	come
me	me
milieu	middle
tournèrent	turned
vers	to
stupéfaits	stunned
rapporta	reported
avait	had
ou	or
chambre	room
secrets	secrets
aurait	would
été	been
ouverte	open
abasourdie	stunned
devient	becomes
clair	clear
maintenant	now
déclara	said
triomphant	triumphant
lucius	lucius
dû	due
ouvrir	open
l'école	the school
expliqué	explained
cher	dear
drago	drago
évident	obvious
j'aurais	I would have
dise	say
quel	what
genre	kind
monstre	monster
cache	cache
là-dedans	there
demande	request
fait	fact
personne	person
l'ait	has
jamais	never
rôder	prowl
peut-être	maybe
faculté	faculty
rendre	make
invisible	invisible
plongeant	plunging
sangsues	leeches
fond	background
déguise	disguises
armure	armor
j'ai	I
lu	read
quelque	some
les	the
goules	ghouls
caméléons	chameleons
lis	read
trop	too
saupoudrant	sprinkling
chrysopes	lacewing
mortes	dead
froissa	froissa
boule	ball
sac	bag
vidé	emptied
tourna	turned
alors	then
comme	as
cause	cause
n'a	did
pu	could
train	train
t'es	you're
cassé	broken
s'il	if it
continue	continues
vouloir	want to
sauver	save
vie	life
finir	finish
tuer	kill
lundi	Monday
monde	world
savait	knew
crivey	crivey
rumeurs	rumors
soupçons	suspicions
multipliaient	multiplied
élèves	students
première	first
année	year
déplaçaient	moved
qu'en	in
groupes	groups
peur	fear
d'être	to be
attaqués	attacked
s'ils	if they
s'aventuraient	ventured
seuls	only
château	castle
ginny	ginny
toujours	always
assise	sitting
côté	side
cours	during
sortilèges	spells
bouleversée	upset
fred	fred
george	george
essayé	tried
sa	its
bonne	good
couvrant	covering
peaux	skins
bêtes	beasts
cachant	hiding
statues	statues
sauter	jump
dessus	top
surprise	surprise
durent	last
mettre	put
fin	end
efforts	efforts
bord	edge
l'apoplexie	apoplexy
menaça	threatened
d'écrire	write
mrs	mrs
faisaient	were
donner	give
cauchemars	nightmares
trafic	traffic
talismans	talismans
amulettes	amulets
autres	other
gris-gris	grey-grey
organisé	organized
dos	back
professeurs	teachers
neville	neville
londubat	londubat
acheté	bought
gros	wholesale
oignon	onion
vert	green
malodorant	smelly
pointe	tip
cristal	crystal
violet	purple
queue	tail
salamandre	salamander
décomposition	decomposition
camarades	comrades
firent	did
observer	observe
courait	ran
aucun	no
danger	danger
puisqu'il	since it
appartenait	belonged
famille	family
sorciers	wizards
sang	blood
pur	pure
rusard	rusard
victime	victim
air	air
apeuré	frightened
sait	knows
aussi	also
suis	am
presque	almost
cracmol	cracmol
deuxième	second
semaine	week
décembre	December
passa	spent
classes	classes
noms	names
resteraient	would
vacances	holiday
noël	christmas
s'inscrivirent	becoming a
dire	say
resterait	would
semblé	seemed
particulièrement	particularly
louche	ladle
ainsi	as well
moment	time
idéal	ideal
usage	use
essayer	try
tirer	shoot
nez	nose
malheureusement	unfortunately
potion	potion
n'était	there was
qu'à	as
moitié	half
faite	made
fallait	had to
corne	horn
bicorne	bicorne
peau	skin
serpent	snake
d'arbre	tree
cap	cape
or	gold
seul	only
endroit	place
pouvaient	could
trouver	find
l'armoire	the cabinet
personnelle	personal
rogue	rogue
for	for
intérieur	inside
préférait	preferred
affronter	face
légendaire	legendary
serpentard	slytherin
plutôt	rather
surpris	surprised
voler	fly
bureau	office
faudra	will
diversion	diversion
temps-là	time
l'un	one
d'entre	of
glissera	slip
faut	must
regardèrent	looked
inquiet	worried
crois	believe
vaut	worth
aille	go
ingrédients	ingredients
poursuivit	continued
naturel	natural
vous	you
deux	two
seriez	would
renvoyés	returned
si	if
faisiez	did
n'ai	haven
eu	had
d'ennuis	trouble
risque	risk
moins	less
suffira	suffice
provoquer	cause
assez	enough
chahut	ruckus
occuper	care
cinq	five
bonnes	good
minutes	minutes
faible	low
près	near
facile	easy
réveiller	wake up
dragon	dragon
endormi	asleep
crevant	crevant
commun	common
potions	potions
lieu	place
jeudi	Thursday
après-midi	afternoon
grands	great
cachots	dungeons
façon	how
habituelle	usual
vingtaine	twenty
chaudrons	pots
bouillonnaient	raged
tables	tables
lesquelles	which
étaient	were
disposés	willing
balances	scales
bocaux	jars
d'ingrédients	ingredients
circulait	riding
parmi	among
vapeurs	vapors
fétides	foul
faisant	making
remarques	remarks
acerbes	bitter
sous	under
ricanements	sneers
chouchou	darling
bombardait	bombarded
yeux	eyes
poissons	fish
prenait	took
bocal	jar
sachant	knowing
écoperaient	would be paying
retenue	withholding
s'avisaient	be advised
d'en	to
autant	as much
d'enflure	swelling
préparée	prepared
beaucoup	a lot
liquide	liquid
important	important
occupait	occupied
l'esprit	the spirit
attendait	waiting
signal	signal
peine	penalty
celui-ci	it
vint	came
moquer	fun
claire	clear
s'éloigna	walked away
critiquer	criticize
regard	look
fit	fit
signe	sign
pencha	bent
sortit	went out
poche	pocket
pétard	firecracker
dr	dr
flibuste	flibuste
donna	donna
baguette	wand
magique	magic
crépiter	sizzle
n'avait	had
quelques	a few
secondes	seconds
lança	launched
goyle	goyle
explosa	exploded
aussitôt	as soon
aspergeant	sprinkling
toute	any
classe	class
atteints	with
projections	projections
mirent	started
hurler	scream
reçut	received
plein	full
visage	face
enfler	swell
ballon	ball
même	even
mains	hands
taille	size
assiette	plate
essayait	tried
sans	without
succès	success
ramener	bring
l'ordre	the order
confusion	confusion
régnait	reigned
présent	this
glisser	drag
hors	out
silence	silence
rugit	roars
ceux	those
ont	have
reçu	received
venez	come
antidote	antidote
saurai	know
s'efforça	tried
éclater	burst
s'avancer	advance
penchant	leaning
poids	weight
grosseur	size
melon	melon
allait	would
gorgée	sip
d'antidote	antidote
revenir	return
jambes	legs
oreilles	ears
antérieure	earlier
revint	returned
discrètement	discreetly
portant	bearing
robe	dress
retrouvé	found
aspect	aspect
habituel	usual
examina	examined
retira	retired
débris	debris
noircis	blackened
découvre	discover
lancé	launched
murmure	whisper
pouvez	can
être	be
absolument	absolutely
sûrs	safe
cette	this
sera	will be
renvoyée	returned
fixait	set
avoir	have
l'air	the air
stupéfait	stunned
dix	ten
tard	later
soulagement	relief
sonner	ring
cloche	bell
annonçait	announced
chemin	path
l'ai	I
nouveaux	new
mit	mit
touiller	touiller
fébrilement	feverishly
mixture	mixture
prêt	loan
quinzaine	fifteen
jours	days
joyeux	happy
peut	can
prouver	prove
rassurer	reassure
qu'est-ce	what is this
capable	able
s'attendre	expect
pire	worst
écumait	écumait
bouillons	broths
traversaient	crossed
hall	hall
d'entrée	input
lorsqu'ils	when they
virent	saw
groupe	group
d'élèves	students
rassemblés	gathered
tableau	table
d'affichage	display
morceau	song
parchemin	parchment
venait	came
juste	just
d'y	there
épinglé	pinned
seamus	seamus
finnigan	finnigan
dean	dean
thomas	thomas
visiblement	obviously
surexcités	excited
d'approcher	to approach
ouvert	open
annonça	announced
séance	session
soir	evening
apprendre	learn
battre	beat
utile	useful
temps	time
courent	run
répliqua	replied
lut	lut
l'annonce	the announcement
intérêt	interest
vrai	true
servir	serve
d'accord	agreement
huit	eight
heures	hours
soir-là	evening
dîner	dinner
hâtèrent	hurried
grande	great
longues	long
estrade	stage
dorée	golden
installée	installed
contre	against
mur	wall
éclairée	lit
milliers	thousands
chandelles	candles
flottaient	floating
plafond	ceiling
velours	velvet
noir	black
quasi-totalité	almost all
rassemblée	collected
main	hand
surexcité	excited
prof	prof
quelqu'un	someone
m'a	me
champion	champion
jeune	young
s'interrompit	if interrupted
grognement	grunt
gilderoy	gilderoy
lockhart	lockhart
d'apparaître	to appear
l'estrade	the stage
élégamment	elegantly
vêtu	dressed
violette	violet
accompagné	accompanied
habillé	dressed
habitude	usual
agita	agita
demander	ask
approchez-vous	approach
voit	see
m'entend	hear me
parfait	perfect
dumbledore	dumbledore
donné	given
l'autorisation	the authorization
d'ouvrir	open
enseigner	teach
méthodes	methods
défense	defence
cas	case
auriez	would
besoin	need
face	in the face of
agression	aggression
quelconque	any
cela	this
m'est	I
d'innombrables	countless
amples	more
détails	details
renvoie	returns
collection	collection
complète	complete
mes	my
livres	books
vais	'll
présenter	present
mon	my
assistant	wizard
éclatant	bright
notions	concepts
matière	material
sportivement	sportingly
accepté	accepted
partenaire	partner
petite	small
démonstration	demonstration
guise	as
préambule	preamble
inquiétez	worry
votre	your
maître	master
état	state
j'en	I
aurai	will
serait	would be
arrivaient	arrived
s'entre-tuer	kill
murmura	whispered
l'oreille	the ear
rictus	grin
continuer	continue
l'avait	had
regardé	watched
manière	way
enfui	away
toutes	all
placèrent	placed
saluèrent	greeted
s'inclina	bowed
moulinets	reels
contentait	just
agacé	annoyed
levèrent	rose
baguettes	chopsticks
épées	swords
voyez	see
tenons	would like
nos	our
position	position
combat	combat
réglementaire	regulatory
foule	crowd
spectateurs	spectators
silencieux	silent
aurons	will
compté	counted
trois	three
jetterons	will
premier	first
sort	fate
ni	or
l'autre	the other
cherchera	will
l'adversaire	the opponent
n'en	do
sûr	course
montrer	show
dents	teeth
tous	all
brandirent	brandirent
par-dessus	above
épaule	shoulder
expelliarmus	expelliarmus
s'écria	cried
éclair	flash
aveuglant	blinding
lumière	light
rouge	red
fut	was
soulevé	raised
sol	soil
violemment	violently
projeté	projected
bas	the bottom
pierre	stone
glissa	slipped
lentement	slowly
s'affala	if affala
terre	earth
applaudirent	cheered
bruyamment	loudly
petits	small
souliers	shoes
blessé	injured
demanda-t-elle	he asked as she
aiguë	acute
quelle	what
importance	importance
répondirent	answered
chœur	chorus
releva	rose
tant	as
mal	evil
chapeau	hat
tombé	fallen
cheveux	hair
ondulés	wavy
dressés	prepared
voilà	this is
excellente	excellent
remontant	going back
assuré	insured
s'agit	is
sortilège	hex
désarmement	disarmament
perdu	lost
ma	my
ah	ah
merci	thank you
miss	miss
brown	brown
idée	idea
offenser	offend
j'avais	I had
deviné	guessed
aviez	had
empêcher	prevent
instructive	informative
assassin	assassin
car	because
spectacle	show
terminé	finished
jouer	play
passer	pass
voulez	want to
m'aider	help me
descendirent	went down
répartirent	spread
équipes	teams
ensemble	all
justin	justin
finch-fletchley	finch-fletchley
s'occupa	took
séparer	separate
vieille	old
équipe	team
narquois	mocking
mettrez	will
potter	potter
naturellement	naturally
vois	see
choses	things
glacial	icy
mr	mr
plaît	please
allez	go
célèbre	famous
granger	granger
ferez	will
bulstrode	bulstrode
s'avança	advanced
ironique	ironic
élève	student
rappelait	reminded
illustration	illustration
harpies	harpies
elle	it
épaules	shoulders
carrées	square
mâchoire	jaw
proéminente	prominent
adressa	addressed
auquel	which
mettez-vous	put yourself
remonté	reassembled
n'oubliez	do not forget
saluer	greet
bref	brief
quitter	leave
attention	attention
levez	lift
vos	your
cria	cried
jetez	throw
désarmer	disarm
adversaire	opponent
dis	say
voulons	want to
d'accident	accident
brandit	holds up
jeté	cast
tel	such
choc	shock
l'impression	printing
poêle	stove
vacilla	wavered
instant	now
attendre	wait
pointa	pointa
criant	screaming
rictusempra	rictusempra
jet	jet
argentée	silver
atteignit	reached
ventre	belly
plia	folded
respiration	breathing
sifflante	wheezing
rien	nothing
d'autre	on the other
s'exclama	exclaimed
tomber	fall
genoux	knees
chatouillis	chatouillis
riait	laughed
n'arrivait	there was
bouger	move
pensa	thought
loyal	fair
erreur	error
souffle	breath
court	short
parvint	managed
articuler	articulate
tarentallegra	tarentallegra
s'agiter	shake
danse	dance
effrénée	unbridled
incapable	unable
contrôler	control
stop	stop
Ça	It
suffit	just
intervint	intervened
finite	finite
incantatem	incantatem
s'exclama-t-il	exclaimed,-t-he
pieds	feet
cessèrent	ceased
danser	dance
fou	crazy
s'arrêta	stopped
passait	passed
d'eux	of them
nuage	cloud
fumée	smoke
verdâtre	greenish
flottait	floated
au-dessus	above
allongés	elongated
d'haleine	breath
soutenait	supported
livide	livid
s'excusant	apologizing
dégâts	damage
qu'avait	that was
faits	facts
cassée	broken
millicent	millicent
revanche	contrast
pleine	full
action	action
abandonnées	discontinued
servaient	served
elles	they
battaient	fighting
nues	naked
coincé	stuck
gémissait	moaning
douleur	pain
précipita	rushed
libérer	free
hou	hou
observant	observing
résultat	result
affrontements	clashes
ferais	would
neutraliser	neutralize
mauvais	bad
sorts	spells
prenons	take
volontaires	volunteers
exemple	example
mauvaise	bad
coupa	cut
sème	sows
désolation	desolation
chaque	each
essaye	try
moindre	less
grand-chose	much
proposa	proposed
perfide	treacherous
approuva	approved
pointera	point
feras	shalt
leva	rose
propre	own
exécuta	executed
gestes	gestures
compliqués	complicated
laissa	let
dépêchait	hurry
ramasser	pick up
holà	whoa
énervée	upset
s'approcha	approached
chuchota	whispered
sourit	smiles
pourriez-vous	could you
bloquer	block
plairait	would like
coin	corner
lèvres	lips
fais	do
t'ai	you've
donnant	giving
tape	tape
amicale	friendly
l'épaule	the shoulder
laisse	leaves
l'écoutait	listened to it
allez-y	go for it
s'écria-t-il	cried it
serpensortia	serpensortia
l'extrémité	the end
abasourdi	stunned
jaillir	squirt
long	long
tomba	fell
dressa	set
mordre	bite
recula	backed
poussant	pushing
cris	cree
terreur	terror
bougez	move
tranquillement	quietly
ravi	ravi
immobile	still
débarrasser	rid
m'en	me
occupe	deals
explosion	explosion
retentit	sounds
disparaître	disappear
reptile	reptile
airs	air
retomba	fell
loin	far
grand	great
rage	rage
sifflant	whistling
tortilla	tortilla
nouveau	new
découvrant	discovering
crochets	hooks
sut	sut
poussa	pushed
agir	act
n'eut	had
d'avoir	to have
pris	taken
lui-	him-
décision	decision
portèrent	brought
monté	mounted
roulettes	casters
bêtement	stupidly
laisse-le	let the
tranquille	quiet
miracle	miracle
docile	docile
qu'un	a
tuyau	hose
d'arrosage	watering
tournés	shot
sentit	felt
crainte	fear
n'attaquerait	do not attack
d'expliquer	to explain
s'attendait	expected
soulagé	relieved
étonné	surprised
reconnaissant	recognizing
certainement	certainly
effrayé	scared
joues	cheeks
lança-t-il	"he shouted,
talons	heels
s'enfuit	fled
disparut	disappeared
bouffée	puff
noire	black
observait	watched
étrange	strange
rusé	cunning
calculateur	calculator
déplut	displeased
profondément	deeply
également	also
présageait	presaged
bon	good
tira	drew
manche	sleeve
viens	just
s'en	in
l'entraîna	the led
accompagna	accompanied
marchant	walking
pressés	in a hurry
mesure	measurement
avançaient	advanced
s'écartaient	deviated
passage	passage
d'attraper	to catch
maladie	disease
dirent	said
mot	word
jusqu'à	up to
aient	have
regagné	returned
commune	common
déserte	deserted
fauteuil	chair
es	es
fourchelang	fourchelang
l'avais	had
s'étonna	was surprised
répéta	repeated
parles	talk
langage	language
serpents	snakes
m'arrive	happens to me
jour	day
zoo	zoo
sortir	out
boa	boa
constrictor	constrictor
cage	cage
exprès	express
failli	bankrupt
attaquer	attack
cousin	cousin
dudley	dudley
longue	long
histoire	history
brésil	brazil
libéré	released
compte	account
l'époque	the time
savais	knew
j'étais	I was
sorcier	sorcerer
t'a	you
sûrement	surely
tas	heap
gens	people
peuvent	can
oh	oh
don	gift
répandu	widespread
saches	to know
commençait	started
s'énerver	get excited
qu'est	that is
n'avais	had
étiez	were
m'avez	I have
parler	talk
langue	language
aurais	would have
n'y	there
étonnant	amazing
paniqué	panicked
encourageais	would encourage
l'attaquer	the attack
effrayant	scary
regarda	looked at
bouche	mouth
bée	eer
parlé	spoken
rendu	rendering
pourrais-je	could I
apercevoir	see
hocha	hocha
d'enterrement	burial
pourtant	yet
comprenait	included
terrible	terrible
m'expliquer	explain to me
répugnant	disgusting
d'arracher	tear
l'aie	the iea
autrement	otherwise
préféré	favorite
finisse	finish
chasseurs	hunters
justement	precisely
l'importance	the importance
parla	spoke
enfin	finally
sourde	deaf
simplement	simply
parce	because
célébrité	celebrity
salazar	salazar
vient	comes
pouvoir	power
maison	home
symbolisée	symbolized
resta	remained
exactement	exactly
croire	believe
arrière-arrière-	back-to-back-
arrière-arrière-petit-fils	back-back-small-wire
faux	false
protesta	protested
saisi	seized
soudain	suddenly
sentiment	feeling
panique	panic
inexplicable	inexplicable
vécu	lived
environ	about
mille	thousand
ans	years
pourrais	could
descendant	descendant
éveillé	awake
entières	whole
nuit-là	night
fente	slot
baldaquin	canopy
neige	snow
fenêtre	window
pouvait-il	could he
père	father
dursley	dursley
interdit	prohibited
poser	ask
questions	questions
essaya	tried
doute	doubt
trouve	find
pensa-t-il	he thought
choixpeau	sorting hat
m'aurait	I would have
envoyé	sent
maison-là	house
début	beginning
t'envoyer	send you
souviens-toi	remember
rappela	reminded
désagréable	unpleasant
retourna	returned
verrait	would
lendemain	next day
botanique	botanical
expliquerait	explain
ordonné	ordered
laisser	let
imbécile	fool
transformée	transformed
blizzard	blizzard
épais	thick
dernier	last
trimestre	quarter
annulé	cancelled
chourave	chourave
chaussettes	socks
écharpes	scarves
racines	roots
mandragore	mandrake
opération	operation
délicate	delicate
qu'elle	it
confier	entrust
quiconque	anyone
mandragores	mandrakes
devenues	become
indispensables	essential
teigne	ringworm
assis	sitting
auprès	with
ruminait	discussed
sombres	dark
pensées	thoughts
partie	part
d'échecs	chess
l'amour	love
ciel	sky
donc	so
décida	decided
suivre	follow
conseil	council
demandant	asking
pourrait	could
fût	was
sombre	dark
l'ordinaire	the ordinary
grisâtre	greyish
tourbillonnait	swirling
fenêtres	windows
d'aller	go
d'abord	first
plusieurs	several
poufsouffle	hufflepuff
auraient	would
partager	share
absorbés	absorbed
conversation	conversation
apparemment	apparently
sérieuse	serious
l'endroit	the place
trouvait	was
eux	them
bribes	bits
disaient	said
caché	hidden
étagères	shelves
écouter	listen
attentivement	carefully
conseillé	recommended
cacher	hide
dortoir	dormitory
expliquait	explained
garçon	boy
costaud	beefy
l'a	the
choisi	chosen
prochaine	next
fasse	do
remarquer	notice
s'y	there
depuis	since
raconté	told
né	born
moldus	muggle
normalement	normally
eton	eton
dont	which
vanter	boast
héritier	heir
d'après	after
ernie	ernie
anxieux	anxiety
fille	girl
nattes	mats
blondes	blondes
réfléchis	think
hannah	hannah
parle	speaks
adeptes	followers
magie	magic
sont	are
capables	capable
connais	know
d'honnêtes	honest
parlent	speak
lui-même	himself
surnommé	dubbed
langue-de-serpent	language-of-snake
général	general
s'éleva	rose
table	table
écrit	written
ennemis	enemies
l'héritier	the heir
prenez	take
garde	guard
ennuis	trouble
hasard	random
chat	cat
attaqué	attacked
énervé	pissed off
prenant	taking
photos	photos
surtout	especially
allongé	lying
boue	mud
gentil	nice
paraissait	seemed
convaincue	convinced
tu-sais-qui	you-know-who
baissa	lowered
mystérieux	mysterious
obligeant	forcing
rapprocher	closer
entendre	hear
disait	said
survécu	survived
attaque	attack
reprit	took
bébé	baby
réduit	reduced
miettes	crumbs
mage	mage
puissant	powerful
survivre	survive
maléfice	hex
seigneur	lord
ténèbres	darkness
vienne	vienna
concurrence	competition
quels	what
pouvoirs	powers
put	put
supporter	bear
davantage	more
s'éclaircit	clears up
gorge	throat
éclaté	burst
réaction	reaction
pétrifiés	petrified
d'ernie	ernie
devenu	now
cherche	looking
pires	the worst
craintes	fears
trouvaient	were
confirmées	confirmed
terrifiés	terrified
veux	want to
tremblante	trembling
voulais	wanted
véritablement	truly
mordit	bit
prit	took
profonde	deep
inspiration	inspiration
ai	I
reculé	down
buté	stumbled
tremblant	tremblant
membres	members
poussé	pushed
frémissant	quivering
touché	hit
idées	ideas
précipitamment	hurriedly
peux	can
comporte	features
sorcières	witches
neuf	nine
générations	generations
fiche	sheet
féroce	fierce
est-ce	is this
envie	want
d'attaquer	attack
enfants	children
détestes	hate
chez	in
vis	screw
impossible	impossible
détester	hate
verras	see
suivit	followed
chancelant	tottering
colère	anger
cogna	knocked
dur	hard
projeta	projected
bonjour	hello
hagrid	hagrid
levant	rising
entièrement	fully
passe-montagne	balaclava
laine	wool
couvert	covered
coq	cock
mort	death
tenait	held
pattes	legs
pendait	hung
gantée	gloved
relevé	statement
sois	am
relevant	under
faites-la	do the
montra	showed
inanimé	inanimate
tue	kills
expliqua-t-il	he explained
renards	foxes
gobelin	goblin
buveur	drinker
autorisation	authorization
directeur	director
protection	protection
poulailler	chicken coop
sourcils	eyebrows
broussailleux	bushy
parsemés	dotted
flocons	flakes
observèrent	watched
vas	vas
m'as	me
soucis	worries
résoudre	solve
répéter	repeat
venaient	came
j'y	I
métamorphose	metamorphosis
commence	begins
bientôt	soon
dois	do
chercher	search
monta	went up
l'escalier	the stairs
lourd	heavy
d'air	air
glacé	glossy
s'engouffrait	rushing
vitre	glass
soufflé	blown
torches	torches
parcouru	traveled
trébucha	stumbled
poing	fist
l'estomac	the stomach
étendu	extended
froid	cold
figé	frozen
expression	expression
stupeur	stupor
fixés	set
silhouette	silhouette
offrait	offered
eût	had
nick	nick
quasi-sans-tête	quasi-without-head
fantôme	ghost
couleur	color
gris	grey
perle	pearl
transparence	transparency
ressemblait	looked like
épaisse	thick
quinze	fifteen
centimètres	centimeters
horizontale	horizontal
décollée	peeled off
celui	the
cœur	heart
battant	flying
rompre	break
côtes	coast
côtés	sides
file	file
d'araignées	spiders
s'enfuyaient	ran away
vitesse	speed
dehors	outside
salles	rooms
proches	close
filer	spinning
n'aurait	would
su	su
trouvé	found
abandonner	abandon
secours	relief
cependant	however
croirait	like
innocence	innocence
restait	remained
proie	prey
s'ouvrit	opened
peeves	peeves
frappeur	batting
surgit	arises
tiens	want
pote	buddy
caquetant	cackling
poulet	chicken
mijote	simmers
rôde-t-il	lurking there
saut	jump
périlleux	perilous
aperçut	saw
quasi-	quasi-
sans-tête	without header
l'arrêter	the stop
nouvelle	new
vivant	living
fantÔme	ghost
À	To
l'abri	the shelter
sauve	saves
attaaaaaque	attaaaaaque
bang	bang
unes	each
portes	doors
s'ouvrirent	opened
volée	fly
lieux	places
crime	crime
régna	reigned
telle	such
faillit	almost
piétiné	trampled
affolés	bewildered
noirci	blackened
hurlaient	screaming
réclamer	claim
retrouva	found
plaqué	plated
arriva	came to pass
suivie	followed
brandissant	waving
retentir	sound
détonation	detonation
rétablit	restores
ordonna	ordered
s'était-il	was he
qu'ernie	that ernie
amis	friends
apparurent	appeared
montrant	showing
doigt	finger
geste	gesture
théâtral	theatrical
macmillan	macmillan
sèchement	curtly
sautillait	bobbing
têtes	heads
scène	scene
aimait	loved
chaos	chaos
penchaient	leaning
nick-quasi-sans-	nick-quasi-without-
examiner	review
chanter	sing
tes	your
ruses	tricks
décidément	decidedly
t'amuse	fun
aboya	barked
tirant	pulling
transporté	transported
convenait	should
finalement	finally
éventail	range
l'agiter	the shake
pousser	push
l'étage	the floor
supérieur	higher
forme	form
noircie	blackened
portée	scope
brise	breeze
l'éventail	the range
retrouvèrent	found
déserté	deserted
jure	swear
relève	notes
compétence	competence
angle	angle
avancèrent	forth
gargouille	gargoyle
extrême	extreme
laideur	ugliness
sorbet	sorbet
citron	lemon
passe	pass
s'anima	if anima
malgré	despite
l'idée	the idea
l'attendait	the expected
s'empêcher	help
émerveillé	amazed
s'élevait	was
escalier	staircase
colimaçon	spiral
tournait	turned
escalator	escalator
s'avancèrent	advanced
marches	steps
referma	closed
sourd	deaf
s'élevèrent	rose
effort	effort
cercles	circles
successifs	successive
emmenèrent	took
haut	top
légèrement	slightly
étourdi	dizzy
chêne	oak
reflets	reflections
chatoyants	shimmering
heurtoir	knocker
cuivre	copper
griffon	griffon
qu'habitait	he was living
albus	albus
