18	18
lunard	lunard
queudver	queudver
patmol	patmol
et	and
cornedrue	cornedrue
il	it
fallut	took
un	a
bon	good
moment	time
pour	for
que	that
l'absurdité	the absurdity
de	of
cette	this
affirmation	affirmation
pénètre	penetrates
les	the
esprits	spirits
ron	ron
fut	was
le	the
premier	first
à	to
exprimer	express
ce	this
harry	harry
pensait	thought
vous	you
êtes	are
complètement	completely
cinglés	the weirdos
tous	all
deux	two
dit-il	he said
ridicule	ridiculous
dit	said
hermione	hermione
d'une	a
voix	voice
faible	low
peter	peter
pettigrow	pettigrow
est	is
mort	death
c'est	it is
lui	him
qui	that
l'a	the
tué	killed
y	there
a	has
douze	twelve
ans	years
en	in
montrant	showing
black	black
dont	which
visage	face
était	was
agité	restless
tics	tics
j'avais	I had
l'intention	the intention
faire	do
grogna-t-il	"he grunted
découvrant	discovering
ses	its
dents	teeth
jaunes	yellow
mais	but
petit	small
réussi	successful
m'avoir	I have
soir	evening
ne	do
m'aura	I will
pas	not
se	is
jeta	threw
alors	then
sur	on
croûtard	croûtard
faisant	making
tomber	fall
pattenrond	pattenrond
poussa	pushed
hurlement	howl
douleur	pain
lorsque	when
sirius	sirius
tomba	fell
sa	its
jambe	leg
cassée	broken
non	not
hurla	screamed
lupin	lupin
précipitant	precipitating
qu'il	it
tira	drew
arrière	rear
attends	wait
tu	you
peux	can
ça	it
comme	as
faut	must
qu'ils	they
comprennent	include
nous	we
devons	must
leur	their
expliquer	explain
on	it
expliquera	explain
après	after
gronda	gronda
essayant	trying
repousser	push
tendait	tended
vainement	in vain
la	the
main	hand
vers	to
poussait	pushing
petits	small
cris	cree
goret	goret
griffant	clawing
cou	neck
dans	in
efforts	efforts
s'enfuir	escape
ils	they
ont	have
droit	right
tout	all
savoir	know
haleta	gasped
retenait	held
toutes	all
forces	forces
c'était	it was
compagnon	companion
même	even
certaines	some
choses	things
je	I
n'ai	haven
encore	yet
comprises	included
dois	do
vérité	truth
cessa	ceased
débattre	discuss
yeux	eyes
caves	cellars
toujours	always
fixés	set
immobilisait	tied up
entre	between
mains	hands
griffées	signature
mordues	bitten
sanglantes	bloody
très	very
bien	well
répondit	replied
sans	without
quitter	leave
rat	rat
des	of
dis-leur	tell them
voudras	like
dépêche-toi	hurry
remus	remus
veux	want to
enfin	finally
commettre	commit
meurtre	murder
lequel	which
m'a	me
mis	put
prison	prison
fous	crazy
lier	link
tremblante	trembling
regardant	looking at
Ça	It
suffit	just
m'en	me
vais	'll
essaya	tried
relever	meet
s'appuyant	based
valide	valid
reprit	took
baguette	wand
magique	magic
pointa	pointa
allez	go
m'écouter	listen to me
calmement	calmly
tenez	hold
pendant	during
parle	speaks
s'appelle	is called
croÛtard	croÛtard
remettre	back
poche	pocket
celui-ci	it
débattait	struggling
trop	too
fort	fort
chancela	reeled
perdit	lost
l'équilibre	the balance
précipita	rushed
l'aider	the help
rasseoir	sit back down
lit	bed
accorder	grant
regard	look
tourna	turned
témoins	witnesses
vu	seen
mourir	die
rue	street
pleine	full
monde	world
n'ont	have
cru	raw
voir	see
lança	launched
d'un	a
ton	your
féroce	fierce
fixé	set
tortillait	tortillait
avait	had
hochant	nodding
tête	head
moi-même	myself
l'ai	I
jusqu'à	up to
voie	way
carte	card
car	because
du	the
maraudeur	marauder
ment	ment
jamais	never
vivant	living
tient	holds
échangèrent	exchanged
éloquent	eloquent
étaient	were
histoire	history
n'avait	had
aucun	no
sens	meaning
comment	how
pouvait-il	could he
être	be
finalement	finally
son	its
séjour	stay
azkaban	azkaban
dû	due
détraquer	haywire
cerveau	brain
pourquoi	why
jouait-il	was he playing
jeu	game
prit	took
parole	word
qu'elle	it
s'efforçait	tried
maîtriser	master
si	if
elle	it
essayait	tried
raisonner	reason
professeur	professor
dit-elle	she said
peut	can
impossible	impossible
savez	know
serait-ce	would it be
calme	quiet
s'il	if it
classe	class
répondait	met
question	question
élève	student
parce	because
qu'on	we
l'aurait	would have
su	su
été	been
animagus	animagus
étudié	studied
animagi	animagi
avec	with
mcgonagall	mcgonagall
j'ai	I
vérifié	verified
mes	my
devoirs	duties
ministère	department
possède	has
liste	list
sorcières	witches
mages	the magi
faculté	faculty
transformer	transform
animaux	animals
existe	there is
registre	registry
indique	indicates
quel	what
animal	animal
peuvent	can
prendre	take
forme	form
leurs	their
signes	signs
particuliers	individuals
permet	allows
reconnaître	recognize
consulté	consulted
j'y	I
ai	I
trouvé	found
n'y	there
eu	had
sept	seven
depuis	since
début	beginning
siècle	century
figure	figure
admira	admired
intérieurement	inwardly
qu'hermione	as hermione
déployait	deployed
éclata	broke out
rire	laugh
avez	have
raison	reason
n'a	did
existait	was
poudlard	hogwarts
trois	three
répertoriés	listed
vraiment	really
raconter	tell
toute	any
l'histoire	the story
continuait	continued
d'observer	observe
chaque	each
geste	gesture
faisait	was
tenter	try
attendu	expected
envie	want
d'attendre	wait
plus	more
longtemps	for a long time
faudra	will
m'aides	help me
connais	know
s'interrompit	if interrupted
grincement	grinding
soudain	suddenly
venait	came
retentir	sound
derrière	behind
eux	them
porte	door
s'était	had
ouverte	open
seule	only
retourna	returned
puis	then
s'avança	advanced
regarda	looked at
palier	bearing
personne	person
maison	home
hantée	haunted
rappela	reminded
regardait	watched
air	air
intrigué	intrigued
cabane	hut
hurlante	howling
villageois	villagers
entendaient	heard
moi	me
poussais	pushing
d'ailleurs	moreover,
ici	here
commence	begins
l'époque	the time
où	where
suis	am
devenu	now
loup-garou	loup-garou
n'avais	had
mordu	bitten
téméraire	reckless
paraissait	seemed
grave	serious
fatigué	tired
voulut	wanted
dire	say
quelque	some
chose	thing
fit	fit
taire	shut up
fixait	set
intense	intense
j'étais	I was
garçon	boy
quand	when
parents	parents
essayé	tried
n'existait	there was
traitement	treatment
potion	potion
préparée	prepared
rogue	rogue
une	a
découverte	discovery
récente	recent
me	me
contrôler	control
prends	take
semaine	week
précède	above
lune	moon
reste	rest
lucide	lucid
temps	time
ma	my
transformation	transformation
réfugie	refuge
mon	my
bureau	office
qu'un	a
loup	wolf
inoffensif	harmless
fin	end
avant	before
tue-loup	tue-loup
ait	has
devenais	became
véritable	true
monstre	monster
fois	time
par	by
mois	months
semblait	seemed
puisse	can
étudier	study
autres	other
refuseraient	refuse
certainement	certainly
enfants	children
soient	are
exposés	exposed
au	the
danger	danger
représentais	pictured
époque	time
dumbledore	dumbledore
devint	became
directeur	director
l'école	the school
éprouva	felt
compassion	compassion
assura	assura
qu'en	in
prenant	taking
précautions	precautions
raisons	reasons
études	studies
normalement	normally
soupira	sighed
plusieurs	several
saule	willow
cogneur	slugger
planté	planted
l'année	the year
arrivé	arrived
cause	cause
poursuivit	continued
autour	around
accablé	overwhelmed
tunnel	tunnel
mène	leads
spécialement	specially
bâtis	built
intention	intention
sortir	out
château	castle
m'enfermait	I enclosed
durait	lasted
métamorphose	metamorphosis
l'arbre	the tree
l'entrée	the entry
empêcher	prevent
quiconque	anyone
s'y	there
aventurer	venture
dangereux	dangerous
voyait	saw
quoi	what
pouvait	could
aboutir	lead
l'écoutait	listened to it
passion	passion
part	share
n'entendait	did
couinements	squeals
terrifiés	terrified
transformations	transformations
épouvantables	terrible
douloureux	painful
métamorphoser	morph
pouvais	could
mordre	bite
puisque	since
seul	only
mordais	would
donc	so
bruit	noise
faisais	did
hurlements	howling
pensaient	thought
s'agissait	was
fantômes	ghosts
particulièrement	particularly
agressifs	aggressive
encourageait	encouraged
rumeur	rumor
maintenant	now
restée	remained
silencieuse	silent
années	years
habitants	inhabitants
pré-au-lard	pre-to-bacon
n'osent	do not dare to
approcher	approach
dehors	outside
périodes	periods
aussi	also
heureux	happy
première	first
vie	life
amis	friends
excellents	excellent
sûr	course
votre	your
père	father
james	james
potter	potter
entendu	heard
s'apercevaient	saw
disparaissais	disappear
j'inventais	I was creating
sorte	so
d'histoires	stories
absence	absence
racontais	told
mère	mother
malade	sick
j'allais	I was going to
terrorisé	terrorized
l'idée	the idea
laissent	leave
apprenaient	learning
fini	finished
découvrir	discover
m'ont	I have
laissé	left
contraire	contrary
fait	fact
rendait	made
métamorphoses	metamorphoses
supportables	bearable
meilleurs	best
moments	moments
sont	are
devenus	become
stupéfait	stunned
effet	effect
fallu	had to
parvenir	send
présent	this
élèves	students
brillants	brilliant
avoir	have
conséquences	consequences
terribles	terrible
cela	this
surveille	monitors
près	near
ceux	those
essayent	try
devenir	become
eut	had
besoin	need
l'aide	using
arriver	getting
cours	during
notre	our
cinquième	fifth
année	year
d'études	studies
désormais	now
chacun	each
d'eux	of them
volonté	will
aidait-il	helped-it
demanda	asked
déconcertée	bewildered
tenir	take
compagnie	company
sous	under
d'êtres	beings
humains	human
d'animaux	animals
risquaient	might
rien	nothing
représente	represents
sortaient	out
servant	serving
cape	cape
d'invisibilité	invisibility
transformaient	transformed
arrivait	arrived
glisser	drag
branches	branches
coups	shots
appuyer	support
nœud	node
racine	root
immobilise	stop
descendaient	down
rejoignaient	joined
influence	influence
moins	less
corps	body
celui	the
esprit	spirit
restait	remained
humain	human
grogna	" 
contempler	contemplate
d'avidité	greed
déformait	deformed
traits	features
viens	just
pouvions	could
quatre	four
avions	aircraft
possibilités	opportunities
amuser	have fun
nuit	night
quittions	leave
rôder	prowl
village	village
parc	park
prenaient	took
l'aspect	the aspect
suffisamment	enough
grands	great
neutraliser	neutralize
cas	case
crois	believe
d'autres	other
aient	have
l'occasion	the opportunity
d'explorer	explore
détail	detail
ou	or
ainsi	as well
avons	have
pu	could
établir	establish
signant	signing
nos	our
surnoms	nicknames
douceur	smooth
pattes	legs
chien	dog
queue	tail
ressemble	looks like
lombric	earthworm.
commença	started
l'interrompit	the interrupted
fit-elle	"she
remarquer	notice
promener	walk
loup-garo	wolf-garo
serait-il	would it be
passé	past
aviez	had
fausser	distort
ayez	have
quelqu'un	someone
pensée	thought
hante	haunts
souvent	often
failli	bankrupt
produire	produce
plaisantions	joked around
étions	were
jeunes	young
insouciants	carefree
confiance	trust
éperdue	frantic
habileté	skill
intelligence	intelligence
parfois	sometimes
senti	felt
coupable	guilty
d'avoir	to have
trahi	betrayed
m'avait	I had
accepté	accepted
qu'aucun	no
autre	other
d'école	school
doutait	doubted
violais	violais
règles	rules
établies	established
propre	own
sécurité	security
celle	the
amené	led
camarades	comrades
totalement	totally
interdit	prohibited
j'oubliais	I forgot
sentiment	feeling
culpabilité	guilt
réunissions	together
préparer	prepare
escapades	getaways
suivant	following
changé	changed
s'étaient	had
durcis	hardened
dégoût	disgust
lui-même	himself
long	long
livré	delivered
combat	combat
demandant	asking
devais	had to
révéler	reveal
lâche	loose
aurait	would
avoue	admit
entraîné	led
tiens	want
donné	given
travail	work
rejeté	rejected
partout	everywhere
gagner	win
convaincre	convince
s'introduisait	if introduced
utilisant	using
procédés	processes
magie	magic
noire	black
appris	learned
auprès	with
voldemort	voldemort
d'être	to be
rapport	report
ces	these
intrusions	intrusion
méfier	beware
s'exclama	exclaimed
détachant	stain remover
qu'est-ce	what is this
là-dedans	there
école	school
condisciples	classmates
reprit-il	"he said
s'est	is
battu	beat
acharnement	hard
poste	post
défense	defence
contre	against
mal	evil
soit	either
confié	entrusted
répété	repeated
jour	day
farce	stuffing
tuer	kill
laquelle	which
participé	participated
malgré	despite
laissa	let
échapper	escape
exclamation	exclamation
méprisante	contemptuous
dédain	disdain
train	train
essayer	try
préparions	prepare
espérant	hoping
parviendrait	would
renvoyer	return
severus	severus
voulu	wanted
tournant	turning
heu	uh
aimions	love
beaucoup	a lot
détestait	hated
jaloux	jealous
talent	talent
joueur	player
quidditch	quidditch
traverser	cross
madame	mrs.
pomfresh	pomfresh
m'accompagnait	accompanied me
jusqu'au	until the
pensé	thought
serait	would be
amusant	fun
suffisait	enough
d'appuyer	support
grand	great
bâton	stick
pouvoir	power
suivre	follow
parvenu	managed
nez	nose
déchaîné	unleashed
vent	wind
rejoint	joined
juste	just
ramener	bring
péril	danger
déjà	already
atteint	reached
bout	end
m'apercevoir	I see
formellement	formally
secret	secret
partir	from
aime	love
lentement	slowly
étiez	were
complice	accomplice
exactement	exactly
glaciale	icy
débarrassa	rid
caché	hidden
