3	3
le	the
magicobus	magicobus
harry	harry
parcourut	went through
plusieurs	several
autres	other
rues	streets
en	in
traînant	dragging
péniblement	painfully
sa	its
valise	suitcase
derrière	behind
lui	him
avant	before
de	of
s'effondrer	collapse
hors	out
d'haleine	breath
sur	on
un	a
muret	wall
magnolia	magnolia
crescent	crescent
fureur	fury
toujours	always
aussi	also
vive	cheers
il	it
resta	remained
long	long
moment	time
sans	without
bouger	move
à	to
écouter	listen
les	the
battements	beats
son	its
cœur	heart
mais	but
au	the
bout	end
dix	ten
minutes	minutes
solitude	solitude
dans	in
cette	this
rue	street
obscure	dark
autre	other
sentiment	feeling
s'empara	seized
la	the
panique	panic
avait	had
beau	beautiful
examiner	review
situation	situation
sous	under
tous	all
angles	angles
jamais	never
ne	do
s'était	had
trouvé	found
tel	such
pétrin	trouble
était	was
dehors	outside
seul	only
monde	world
hostile	hostile
des	of
moldus	muggle
moindre	less
endroit	place
où	where
se	is
réfugier	refuge
pire	worst
c'était	it was
qu'il	it
eu	had
recours	use
puissant	powerful
sortilège	hex
ce	this
qui	that
signifiait	meant
serait	would be
presque	almost
certainement	certainly
expulsé	expelled
poudlard	hogwarts
violé	violated
avec	with
tant	as
d'impudence	of impudence
décret	decree
restriction	restriction
l'usage	the use
magie	magic
chez	in
sorciers	wizards
premier	first
cycle	cycle
s'étonnait	was surprised to find
n'avoir	have
pas	not
encore	yet
vu	seen
représentants	representatives
du	the
ministère	department
surgir	arise
devant	before
frissonna	shivered
et	and
scruta	watched
qu'allait-il	what was it
arriver	getting
allait-il	was he going to
être	be
arrêté	stopped
ou	or
simplement	simply
banni	banned
pensa	thought
ron	ron
hermione	hermione
sentit	felt
plus	more
désemparé	distraught
sûr	course
que	that
délinquant	offender
auraient	would
tout	all
fait	fact
pour	for
l'aider	the help
ils	they
étaient	were
deux	two
l'étranger	the foreign
maintenant	now
qu'hedwige	that hedwig
partie	part
n'avait	had
aucun	no
moyen	average
contacter	contact
non	not
d'argent	money
moldu	muggle
restait	remained
peu	little
d'or	gold
sorcier	sorcerer
porte-	door-
monnaie	currency
fond	background
reste	rest
fortune	fortune
ses	its
parents	parents
avaient	had
léguée	bequeathed
trouvait	was
londres	london
une	a
chambre	room
forte	strong
gringotts	gringotts
banque	bank
n'aurait	would
sûrement	surely
force	force
traîner	hanging out
jusqu'à	up to
a	has
moins	less
regarda	looked at
baguette	wand
magique	magic
serrait	tightened
main	hand
s'il	if it
déjà	already
exclu	excluded
(le	(the
rythme	pace
s'accéléra	accelerated
douloureusement	painfully
pensée)	thought)
n'était	there was
supplémentaire	additional
aggraverait	worsen
choses	things
disposait	had
cape	cape
d'invisibilité	invisibility
héritée	inherited
père	father
alors	then
pourquoi	why
user	user
d'un	a
rendre	make
légère	light
qu'une	a
plume	pen
puis	then
l'attacher	attach
balai	broom
enfin	finally
s'envelopper	wrap
voler	fly
pourrait	could
prendre	take
argent	money
commencer	start
vie	life
horrible	horrible
perspective	perspective
pouvait	could
rester	stay
indéfiniment	indefinitely
assis	sitting
sinon	otherwise
police	police
finirait	would
par	by
venir	come
demander	ask
faisait	was
pleine	full
nuit	night
contenait	contained
collection	collection
grimoires	grimoires
ouvrit	opened
fouilla	fumbled
affaires	business
dénicher	find
même	even
l'avoir	have
trouvée	found
redressa	straightened
soudain	suddenly
regardant	looking at
nouveau	new
autour	around
curieux	curious
frisson	thrill
nuque	neck
donné	given
l'impression	printing
quelqu'un	someone
l'observait	the observed
déserte	deserted
n'y	there
fenêtre	window
allumée	lit
aux	the
environs	surrounding area
recommença	again
fouiller	search
releva	rose
aussitôt	as soon
crispée	creased
l'avait	had
senti	felt
qu'entendu	as heard
quelque	some
chose	thing
l'espace	the space
étroit	close
entre	between
garage	garage
maison	home
laquelle	which
ténèbres	darkness
l'allée	the aisle
si	if
seulement	only
bougé	moved
aurait	would
su	su
quoi	what
s'agissait	was
chat	cat
errant	wandering
lumos	lumos
marmonna-t-il	mumbled to himself he
projeta	projected
lumière	light
l'aveugla	the aveugla
leva	rose
au-dessus	above
tête	head
surface	surface
crépie	distempered
mit	mit
briller	shine
rayon	radius
lumineux	bright
éclairait	lit
également	also
porte	door
séparait	separated
distingua	distinguished
silhouette	silhouette
massive	massive
dotée	with
grands	great
yeux	eyes
scintillants	sparkling
recula	backed
trébucha	stumbled
contre	against
perdit	lost
l'équilibre	the balance
lâcha	released
fut	was
projetée	projected
airs	air
choc	shock
tendit	handed
bras	arm
arrière	rear
essayer	try
d'amortir	cushion
chute	fall
put	put
éviter	avoid
tomber	fall
brutalement	brutally
caniveau	gutter
instant	now
entendit	heard
détonation	detonation
aveuglante	blinding
jaillit	springs
l'obligeant	the forcing
lever	sunrise
mains	hands
protéger	protect
poussa	pushed
cri	cry
roula	roula
trottoir	sidewalk
juste	just
temps	time
roues	wheels
gigantesques	gigantic
surmontées	overcome
d'énormes	huge
phares	headlights
s'immobilisèrent	if immobilisèrent
crissement	squealing
pneus	tires
l'endroit	the place
précis	specific
tombé	fallen
auparavant	previously
levant	rising
s'aperçut	saw
appartenaient	belonged
bus	bus
violet	purple
double	double
impériale	imperial
venait	came
néant	nil
pare-brise	windshield
écrit	written
lettres	letters
pendant	during
fraction	fraction
seconde	second
demanda	asked
perdre	lose
contrôleur	controller
uniforme	uniform
sauta	jumped
lançant	launching
d'une	a
voix	voice
sonore	sound
bienvenue	welcome
bord	edge
transport	transport
d'urgence	emergency
sorcières	witches
perdition	perdition
faites	do
signe	sign
votre	your
montez	mount
nous	we
vous	you
emmènerons	take
voudrez	want to
je	I
m'appelle	call me
stan	stan
rocade	ring road
serai	am
l'homme	the man
s'interrompit	if interrupted
d'apercevoir	see
ramassa	picked up
près	near
guère	little
âgé	old
devait	should
avoir	have
dix-huit	eighteen
dix-neuf	nineteen
ans	years
oreilles	ears
largement	widely
décollées	unstuck
mal	evil
boutons	buttons
figure	figure
qu'est-ce	what is this
tu	you
faisais	did
terre	earth
s'étonna	was surprised
ton	your
rien	nothing
professionnel	professional
suis	am
dit	said
t'a	you
pris	taken
l'ai	I
exprès	express
répliqua	replied
agacé	annoyed
tordu	twisted
genou	knee
essayé	tried
rattraper	catch up
sang	blood
rappela	reminded
brusquement	suddenly
raison	reason
tourna	turned
direction	management
l'inondaient	the flooding
elle	it
vide	empty
regardes	look at
y	there
grande	great
noire	black
là	there
expliqua	explained
montrant	showing
vaguement	vaguely
on	it
chien	dog
très	very
gros	wholesale
vers	to
regardait	watched
bouche	mouth
entrouverte	ajar
malaise	discomfort
vit	lives
s'étaient	had
posés	posed
cicatrice	scar
forme	form
d'éclair	flash
front	front
c'est	it is
truc	trick
ta	your
n'est	there is
répondit	replied
précipitamment	hurriedly
lissant	smoothing
cheveux	hair
cacher	hide
recherche	search
envie	want
faciliter	facilitate
tâche	task
t'appelles	you call
comment	how
interrogea	asked
neville	neville
londubat	londubat
donnant	giving
nom	name
l'esprit	the spirit
comme	as
ça	it
va	will
veut	wants to
poursuivit-il	he went on
espérant	hoping
changer	change
sujet	about
ouais	yeah
fièrement	proudly
absolument	absolutely
condition	condition
soit	either
ferme	farm
roule	rolls
l'eau	the water
dis	say
donc	so
continua-t-il	he continued
air	air
soupçonneux	suspicious
as	as
vrai	true
agité	restless
bien	well
oui	yes
rapidement	quickly
combien	how
me	me
coûterait	cost
d'aller	go
onze	eleven
mornilles	mornilles
quatorze	fourteen
droit	right
tasse	cup
chocolat	chocolate
chaud	hot
quinze	fifteen
te	te
donne	gives
bouteille	bottle
d'eau	water
chaude	hot
brosse	brush
dents	teeth
couleur	color
choix	choice
retira	retired
porte-monnaie	wallet
fourra	stuffed
quelques	a few
pièces	parts
l'aide	using
hissa	hissa
l'autobus	the bus
posa	posa
dessus	top
cage	cage
d'hedwige	of hedwig
monta	went up
l'intérieur	inside
sièges	seats
été	been
remplacés	replaced
lits	beds
cuivre	copper
alignés	aligned
fenêtres	windows
masquées	hidden
rideaux	curtains
bougies	candles
brûlaient	burned
chandeliers	candlesticks
illuminant	illuminating
parois	walls
lambrissées	paneled
véhicule	vehicle
l'arrière	the rear
minuscule	tiny
coiffé	wearing
bonnet	bonnet
murmura	whispered
merci	thank you
fais	do
conserves	canned
limaces	slugs
retourna	returned
sommeil	sleep
installe-toi	install you
poussant	pushing
lit	bed
situé	located
conducteur	driver
fauteuil	chair
salon	living room
volant	steering wheel
voici	here
notre	our
chauffeur	driver
s'appelle	is called
ernie	ernie
danlmur	danlmur
ern	ern
présente	this
vieux	old
épaisses	thick
lunettes	glasses
adressa	addressed
lissa	lissa
geste	gesture
fébrile	febrile
s'assit	sat
peut	can
aller	go
prenant	taking
place	place
côté	side
eut	had
nouvelle	new
assourdissante	deafening
bascula	tilt
déséquilibré	unbalanced
démarrage	start
trombe	trombe
travers	through
vitre	glass
présent	this
filait	spinning
différente	different
celle	the
quitter	leave
prenait	took
grand	great
plaisir	fun
observer	observe
l'expression	the expression
stupéfaite	stunned
qu'on	we
fasses	do
dit-il	he said
est	is
part	share
pays	country
galles	wales
n'entendent	hear not,
eux	them
méprisant	despising
savent	know
regarder	watch
d'ailleurs	moreover,
font	do
attention	attention
faudrait	should
réveiller	wake up
madame	mrs.
dumarais	dumarais
abergavenny	abergavenny
minute	minute
passa	spent
disparut	disappeared
escalier	staircase
marches	steps
bois	wood
nerveux	nervous
continuait	continued
semblait	seemed
maîtriser	master
cessait	stopped
monter	mount
trottoirs	sidewalks
pourtant	yet
heurtait	facing
obstacle	obstacle
réverbères	street lights
boîtes	boxes
poubelles	garbage
s'écartaient	deviated
bond	bond
approche	approach
reprenaient	resume
leur	their
quand	when
passé	past
redescendit	down
suivi	follow-up
sorcière	witch
teint	complexion
légèrement	slightly
verdâtre	greenish
emmitouflée	wrapped
voyage	travel
êtes	are
arrivée	arrival
joyeux	happy
écrasa	crushed
frein	brake
glissèrent	glissèrent
trentaine	thirty
centimètres	centimeters
l'avant	the front
plaqua	wood, and overlaid
mouchoir	handkerchief
descendit	went down
assuré	insured
lorsqu'elle	when it
sortie	output
jeta	threw
referma	closed
portières	doors
vigoureux	vigorous
foncèrent	foncèrent
chemin	path
campagne	campaign
bordé	lined
d'arbres	trees
laisser	let
passer	pass
autobus	bus
n'arrêtait	never stopped
d'exploser	explode
sautant	jumping
centaines	hundreds
kilomètres	kilometres
coup	blow
incapable	unable
dormir	sleep
allait	would
estomac	stomach
contractait	contracted
pensée	thought
demandait	asked
dursley	dursley
réussi	successful
faire	do
redescendre	down
tante	aunt
marge	margin
plafond	ceiling
ouvert	open
gazette	gazette
lisait	read
attentivement	carefully
langue	language
photo	photo
homme	man
visage	face
émacié	emaciated
longs	long
emmêlés	tangled
clignait	clignait
lentement	slowly
l'œil	the eye
disait	said
cet	this
s'exclama	exclaimed
ont	have
parlé	spoken
télé	tv
stanley	stanley
d'œil	eye
pouffa	pouffa
rire	laugh
sirius	sirius
black	black
hochant	nodding
d'où	where
sors	go out
interdite	prohibited
petit	small
supérieur	higher
première	first
page	page
journal	journal
devrais	should
lire	read
journaux	newspapers
souvent	often
lança-t-il	"he shouted,
approcha	approached
bougie	candle
lut	lut
introuvable	not found
prétendre	claim
titre	title
infâme	infamous
criminel	criminal
détenu	inmate
forteresse	fortress
d'azkaban	of azkaban
échappe	escapes
recherches	research
confirme	confirms
aujourd'hui	today
faisons	do
possible	possible
capturer	capture
déclaré	said
matin	morning
cornélius	cornelius
fudge	fudge
ministre	minister
demandons	ask
instamment	urges
communauté	community
calme	quiet
critiqué	criticized
certains	some
membres	members
fédération	federation
internationale	international
mages	the magi
informé	informed
clair	clear
mon	my
devoir	duty
certaine	some
irritation	irritation
fou	crazy
représente	represents
danger	danger
quiconque	anyone
trouve	find
présence	presence
j'ai	I
obtenu	obtained
l'assurance	insurance
dirait	looks like
mot	word
véritable	true
identité	identity
trompons	wrong
croirait	like
avertis	warned
armé	armed
pistolet	gun
(sorte	(so
dont	which
servent	serve
s'entre-tuer)	kill)
craint	fears
massacre	massacre
celui	the
s'est	is
produit	product
douze	twelve
lorsque	when
tué	killed
treize	thirteen
personnes	people
sort	fate
sombres	dark
seule	only
décharné	gaunt
vivante	living
rencontré	met
vampire	vampire
cours	during
défense	defence
forces	forces
joues	cheeks
cireuses	waxy
l'air	the air
d'en	to
peur	fear
observait	watched
vraiment	really
rendant	making
jetant	throwing
plein	full
jour	day
témoins	witnesses
Ça	It
ces	these
histoires	stories
sombre	dark
pivota	swung
mieux	better
voir	see
partisans	supporters
tu-sais-qui	you-know-who
voldemort	voldemort
machinalement	going through the motions
constellaient	constellaient
devinrent	became
livides	livid
sursauta	gasped
brutal	brutal
entière	full
dut	otc
s'écarter	depart
deviens	become
s'écria	cried
prend	takes
prononcer	pronounce
désolé	sorry
j'avais	I had
oublié	forgot
éteinte	off
j'en	I
ai	I
bat	beats
chamade	pounding
partisan	supporter
reprit	took
d'excuse	excuse
frottant	rubbing
poitrine	chest
proche	close
potter	potter
démoli	demolished
vif	bright
ramena	brought back
mèche	wick
traqués	hunted
plupart	most
savaient	knew
fini	finished
sont	are
tenus	required
tranquilles	quiet
sauf	except
d'après	after
m'a	me
pensait	thought
devenir	become
tu-	you-
sais-qui	know-who
pouvoir	power
finalement	finally
coincer	stuck
milieu	middle
sorti	out
jeté	cast
dévasté	devastated
toute	any
tués	killed
sais	know
après	after
ajouta	added
dramatique	dramatic
éclaté	burst
resté	stayed
debout	standing
rigoler	laugh
renforts	reinforcements
arrivés	arrived
suivis	followed
résister	resist
continuant	continuing
bossu	hunchback
parce	because
l'était	the was
arrivant	arriving
azkaban	azkaban
l'est	the is
devenu	now
lente	slow
préférerais	would prefer
exploser	explode
plutôt	rather
mettre	put
pieds	feet
là-bas	there
cas	case
travail	work
maquiller	makeup
poursuivit	continued
entièrement	fully
ravagée	ravaged
cadavres	corpses
partout	everywhere
qu'ils	they
explication	explanation
explosion	explosion
gaz	gas
grommela	grumbled
évadé	escaped
contemplant	contemplating
fois	time
qu'un	a
prisonnier	prisoner
arrive	happens
s'échapper	escape
comprends	understand
s'y	there
m'étonnerait	I doubt
ait	has
beaucoup	a lot
chances	chances
s'en	in
tirer	shoot
face	in the face of
gardiens	guards
secoué	shaken
voudrais	would like to
parler	talk
d'autre	on the other
sois	am
gentil	nice
penser	think
ventre	belly
reposa	rested
contrecœur	reluctantly
s'appuya	leaned
inquiet	worried
s'empêcher	help
d'imaginer	imagine
passagers	passengers
avez	have
entendu	heard
histoire	history
gonflé	inflated
montgolfière	hot air balloon
l'a	the
ramassé	picked up
essayait	tried
loi	law
transformer	transform
ballon	ball
constituait-il	was it
délit	crime
suffisant	sufficient
l'envoyer	send
savait	knew
prison	prison
chaque	each
terreur	terror
hagrid	hagrid
garde-chasse	gamekeeper
mois	months
l'année	the year
précédente	previous
d'oublier	forget
expression	expression
épouvantée	fearful
annoncé	announced
emmené	taken
l'un	one
hommes	men
courageux	brave
rencontrés	met
roulait	travelling
l'obscurité	the dark
écartant	apart
passage	passage
bornes	terminals
lumineuses	bright
cabines	cabins
téléphoniques	telephone
arbres	trees
buissons	bushes
accablé	overwhelmed
étendu	extended
plumes	feathers
tournait	turned
retournait	returned
sens	meaning
payé	paid
d'avance	advance
apporta	brought
renversa	down
l'oreiller	the pillow
d'anglesey	anglesey
aberdeen	aberdeen
ecosse	scotland
vêtus	dressed
chemises	shirts
chaussés	shod
pantoufles	slippers
descendaient	down
étages	floors
supérieurs	senior
semblaient	seemed to
enchantés	enchanted
bientôt	soon
passager	passenger
enjoignant	directing
est-ce	is this
laisse	leaves
traverse	crosses
tiens-toi	stand
bang	bang
retrouva	found
charing	charing
cross	cross
road	road
immeubles	buildings
bancs	benches
publics	public
serrer	tighten
voie	way
libre	free
ciel	sky
commençait	started
s'éclaircir	clear
l'intention	the intention
heures	hours
dès	as soon
l'ouverture	the opening
ensuite	then
s'enfuirait	if enfuirait
pédale	pedal
s'arrêta	stopped
dérapage	skid
pub	pub
d'aspect	aspect
miteux	shabby
chaudron	cauldron
baveur	leaky
duquel	which
permettait	allowed
d'accéder	access
sortit	went out
aida	aida
descendre	down
bon	good
eh	eh
revoir	review
prêta	lent
aucune	no
exorbités	bulging
fixement	staring
l'entrée	the entry
arrivé	arrived
celui-ci	it
retourner	return
épaule	shoulder
viens	just
appartenait	belonged
posée	asked
d'avoir	to have
avalé	swallowed
seau	bucket
glaçons	ice cubes
personne	person
avez-vous	have you
appelé	called
monsieur	mr.
demanda-t-il	he asked
surexcité	excited
replet	chubby
vêtu	dressed
longue	long
fines	fine
rayures	stripes
épuisé	exhausted
frigorifié	refrigerated
répéta	repeated
fronçant	frowned
sourcils	eyebrows
savais	knew
ravi	ravi
devine	guess
amené	led
jusqu'ici	up here
moi	me
aurions	would
besoin	need
d'être	to be
serra	serra
l'épaule	the shoulder
l'entraîna	the led
voûtée	vaulted
portant	bearing
lanterne	lantern
dessina	drew
bar	bar
tom	tom
patron	boss
vieil	old
édenté	toothless
peau	skin
ridée	wrinkled
ah	ah
l'avez	have
s'exclama-t-il	exclaimed,-t-he
voulez	want to
boire	drink
bière	beer
cognac	cognac
thé	tea
tenait	held
apparurent	appeared
ainsi	as well
jetaient	threw
alentour	around
regards	looks
brillants	brilliant
curiosité	curiosity
aies	have
étais	was
lança	launched
rayonnant	radiant
tandis	while
hibou	owl
d'ernie	ernie
jetait	cast
regard	look
intéressé	interested
par-dessus	above
collègue	colleague
privé	private
sèchement	curtly
invita	invited
suivre	follow
couloir	hallway
résigné	resigned
salut	hi
entraîna	led
l'étroit	the narrow
éclairé	informed
trois	three
pénétrèrent	penetrated
claqua	slammed
doigts	fingers
feu	fire
cheminée	fireplace
pièce	room
s'inclinant	bowing
respectueusement	respectfully
assieds-toi	sit down
auprès	with
s'exécuta	did it
malgré	despite
chaleur	heat
flammes	flames
sentait	felt
frissons	chills
parcourir	browse
corps	body
enleva	removed
chaise	chair
remonta	came up
soigneusement	carefully
plis	folds
pantalon	pants
costume	costume
vert	green
l'occasion	the opportunity
portait	wore
n'en	do
réapparut	reappeared
plateau	tea
lequel	which
disposés	willing
tasses	cups
théière	teapot
petits	small
pains	bread
table	table
quitta	left
refermant	closing
versant	slope
dire	say
belle	beautiful
t'enfuir	run away
oncle	uncle
commençais	started
es	es
sain	healthy
l'essentiel	the essential
beurra	beurra
pain	bread
l'assiette	the plate
mange	eat
exténué	exhausted
seras	will be
peut-être	maybe
content	content
d'apprendre	to learn
avons	have
mis	put
terme	term
gonflement	swelling
intempestif	unexpected
mademoiselle	mademoiselle
marjorie	marjorie
département	department
réparation	repair
accidents	accidents
sorcellerie	witchcraft
envoyés	sent
privet	privet
drive	drive
miss	miss
perforée	perforated
d'amnésie	amnesia
pratiqué	practiced
gardera	keep
souvenir	remember
l'incident	the incident
définitivement	definitely
clos	ended
sourire	smile
l'attitude	the attitude
bienveillant	benevolent
neveu	nephew
préféré	favorite
croyait	believed
trouva	found
répondre	reply
renonça	gave up
t'inquiètes	don't worry
doute	doubt
réaction	reaction
colère	anger
inutile	useless
nier	deny
accepté	accepted
reprendre	resume
l'été	the summer
prochain	next
restes	remains
vacances	holiday
noël	christmas
pâques	easter
parole	word
façon	how
veux	want to
allons	will
diras	say
calmé	calmed down
préoccupé	concerned
famille	family
convaincu	convinced
aimez	love
uns	each
heu	uh
vous-mêmes	you own
songea	songea
démentir	deny
l'intéressait	interested
savoir	know
décider	decide
vas	vas
tes	your
dernières	last
semaines	weeks
beurrant	buttering
deuxième	second
suggère	suggests
prennes	take
ici	here
attendez	wait
l'interrompit	the interrupted
vais	'll
punition	punishment
cligna	blink
voyons	see
garçon	boy
n'allons	not going to
punir	punish
petite	small
agitant	waving
d'impatience	looking forward to
accident	accident
envoyer	send
placé	placed
tels	such
propos	about
dernière	last
reçu	received
avertissement	warning
elfe	elf
gâteau	cake
cuisine	kitchen
rappela-t-il	recalled-t-he
serais	would be
renvoyé	returned
phénomène	phenomenon
reproduisait	reproduced
nette	net
impression	print
l'aise	comfortable
circonstances	circumstances
peuvent	can
devons	must
considération	consideration
climat	climate
actuel	current
n'as	did
cherché	sought
n'est-ce	is this
d'histoires	stories
éclatant	bright
tiens	want
prends	take
toi	you
ronds	round
sortir	out
passait	passed
d'extrêmement	extremely
étrange	strange
l'avait-il	had he
attendu	expected
faisait-il	was it
déplace	moves
s'occuper	care
concernait	concerned
revint	returned
compagnie	company
11	11
pense	think
règle	rule
comprendras	understand
ailles	go
promener	walk
d'accord	agreement
rentre	returns
tombée	fallen
confie	entrust
soin	care
surveiller	monitor
riant	laughing
vaut	worth
trouves	find
s'éclaircit	clears up
bruyamment	loudly
gorge	throat
prit	took
m'en	me
repérer	identify
l'instant	the moment
sait	knows
simple	simple
question	question
n'ont	have
connu	known
d'échec	failure
vus	seen
furieux	furious
léger	lightweight
idée	idea
soudaine	sudden
puis-je	can I
élèves	students
troisième	third
année	year
autorisés	authorized
visiter	visit
pré-au-lard	pre-to-bacon
ma	my
m'ont	I have
signé	signed
autorisation	authorization
pourriez	could
sembla	seemed
ni	or
parent	parent
tuteur	guardian
donniez	give
permission	permission
navré	sorry
règlement	regulation
pourras	can
prochaine	next
crois	believe
amuse-toi	have fun
sourit	smiles
s'avança	advanced
mr	mr
monté	mounted
vos	your
bagages	luggage
suivit	followed
élégant	elegant
plaque	plate
numéro	number
l'aubergiste	the innkeeper
clé	key
serrure	lock
confortable	comfortable
meubles	furniture
chêne	oak
cirés	waxed
brûlait	burned
perchée	perched
armoire	wardrobe
hedwige	hedwig
chouette	owl
plumage	plumage
neige	snow
fit	fit
claquer	slam
bec	bec
vint	came
poser	ask
bruissement	rustle
d'ailes	wings
intelligente	smart
gloussa	chuckled
cinq	five
n'hésitez	please
m'appeler	call me
s'inclina	bowed
longtemps	for a long time
caresser	caress
au-dehors	outside
changeait	changed
passant	from
bleu	blue
velouté	velvety
gris	grey
d'acier	steel
teintant	tinting
nuance	nuance
rosé	rosé
parsemée	dotted
croire	believe
loin	far
drôle	funny
bâillant	yawning
enlever	remove
laissa	let
s'endormit	fell asleep
