21	21
le	the
secret	secret
d'hermione	of hermione
une	a
histoire	history
stupéfiante	amazing
vraiment	really
un	a
miracle	miracle
qu'il	it
n'y	there
ait	has
pas	not
eu	had
de	of
mort	death
jamais	never
rien	nothing
entendu	heard
semblable	similar
chance	chance
que	that
vous	you
ayez	have
été	been
là	there
rogue	rogue
merci	thank you
monsieur	mr.
ministre	minister
voilà	this is
qui	that
vaudra	worth
l'ordre	the order
merlin	merlin
deuxième	second
classe	class
et	and
même	even
première	first
si	if
je	I
peux	can
arranger	arrange
ça	it
beaucoup	a lot
vilaine	ugly
coupure	cut
avez	have
l'œuvre	the work
black	black
j'imagine	I guess
en	in
fait	fact
la	the
dois	do
à	to
potter	potter
weasley	weasley
granger	granger
non	not
les	the
avait	had
ensorcelés	"bewitched"
l'ai	I
tout	all
suite	suite
vu	seen
sortilège	hex
confusion	confusion
juger	judge
par	by
leur	their
comportement	behavior
ils	they
semblaient	seemed to
considérer	consider
était	was
peut-être	maybe
innocent	innocent
n'étaient	there were
responsables	responsible
leurs	their
actes	acts
mais	but
conduite	conduct
aurait	would
pu	could
permettre	allow
s'enfuir	escape
toute	any
évidence	obviously
étaient	were
persuadés	believe
qu'ils	they
pourraient	could
capturer	capture
eux	them
seuls	only
jusqu'à	up to
présent	this
ont	have
toujours	always
réussi	successful
s'en	in
tirer	shoot
bon	good
compte	account
j'ai	I
peur	fear
cela	this
donné	given
opinion	opinion
excessivement	excessively
flatteuse	flattering
d'eux-mêmes	of themselves
bien	well
a	has
bénéficié	received
d'une	a
extraordinaire	extraordinary
indulgence	indulgence
part	share
du	the
directeur	director
l'école	the school
ah	ah
voulez-vous	do you want to
nous	we
avons	have
tous	all
faible	low
pour	for
lui	him
pourtant	yet
est-ce	is this
service	service
rendre	make
accorder	grant
tel	such
traitement	treatment
faveur	for
ce	this
me	me
concerne	for
j'essaye	I try
comme	as
n'importe	any
quel	what
autre	other
élève	student
serait	would be
moins	less
suspendu	suspended
pendant	during
certain	some
temps	time
avoir	have
entraîné	led
ses	its
camarades	comrades
dans	in
situation	situation
aussi	also
périlleuse	perilous
rendez-vous	appointment
au	the
mépris	contempt
règlements	regulations
après	after
toutes	all
précautions	precautions
mises	updates
place	place
sa	its
protection	protection
se	is
promener	walk
ainsi	as well
hors	out
l'enceinte	the speaker
pleine	full
nuit	night
compromettre	compromise
avec	with
loup-garou	loup-garou
assassin	assassin
également	also
des	of
raisons	reasons
croire	believe
s'est	is
rendu	rendering
pré-au-lard	pre-to-bacon
illégalité	illegality
eh	eh
verrons	see
garçon	boy
conduit	led
manière	way
inconsidérée	reckless
ne	do
aucun	no
doute	doubt
harry	harry
continuait	continued
d'écouter	to listen
yeux	eyes
fermés	closed
il	it
sentait	felt
complètement	completely
étourdi	dizzy
paroles	lyrics
entendait	heard
lentes	slow
atteindre	reach
son	its
cerveau	brain
mal	evil
saisir	enter
sens	meaning
l'impression	printing
membres	members
s'étaient	had
changés	changed
plomb	lead
paupières	eyelids
trop	too
lourdes	heavy
soulever	lift
voulu	wanted
rester	stay
allongé	lying
sur	on
lit	bed
douillet	snug
stupéfie	amazing
plus	more
c'est	it is
détraqueurs	détraqueurs
n'avez	do
aucune	no
idée	idea
reculer	back
lorsque	when
repris	taken
conscience	consciousness
train	train
retourner	return
postes	posts
aux	the
entrées	entries
parc	park
cette	this
jeune	young
fille	girl
évanouis	faded
moment-là	time
ligoté	tied up
bâillonné	gagged
apparaître	appear
brancards	stretchers
ai	I
aussitôt	as soon
ramenés	back
château	castle
y	there
eut	had
moment	time
silence	silence
mesure	measurement
retrouvait	found
peu	little
facultés	faculties
éprouvait	felt
sensation	sensation
désagréable	unpleasant
creux	hollow
l'estomac	the stomach
quelque	some
chose	thing
rongeait	gnawed
l'intérieur	inside
ouvrit	opened
sembla	seemed
flou	blur
l'obscurité	the dark
l'infirmerie	the infirmary
quelqu'un	someone
ôté	removed
lunettes	glasses
l'autre	the other
bout	end
salle	room
distingua	distinguished
silhouette	silhouette
madame	mrs.
pomfresh	pomfresh
tournait	turned
dos	back
penchée	leaning
plissant	squinting
aperçut	saw
cheveux	hair
roux	roux
ron	ron
sous	under
bras	arm
tourna	turned
tête	head
hermione	hermione
allongée	elongated
côté	side
rayon	radius
lune	moon
éclairait	lit
visage	face
elle	it
ouverts	open
paraissait	seemed
pétrifiée	petrified
lorsqu'elle	when it
vit	lives
posa	posa
doigt	finger
lèvres	lips
indiquer	indicate
faire	do
pointant	pointing
l'index	the index
main	hand
vers	to
porte	door
entrouverte	ajar
on	it
voix	voice
cornélius	cornelius
fudge	fudge
parlaient	spoke
couloir	hallway
s'avança	advanced
d'un	a
décidé	decided
qu'elle	it
tenait	held
gros	wholesale
morceau	song
chocolat	chocolate
qu'on	we
puisse	can
imaginer	imagine
dit	said
véritable	true
rocher	rock
êtes	are
réveillés	woke up
deux	two
lança-t-elle	"she
ton	your
brusque	sudden
table	table
chevet	bedside
entreprit	undertook
casser	break
morceaux	pieces
l'aide	using
petit	small
marteau	hammer
comment	how
va	will
demandèrent	asked
survivra	will survive
répondit	replied
sombrement	darkly
allez	go
ici	here
qu'est-ce	what is this
faites	do
s'était	had
redressé	restated
remit	gave
prit	took
baguette	wand
magique	magic
absolument	absolutely
voir	see
dit-il	he said
apaisante	soothing
capturé	captured
est	is
enfermé	locked
là-haut	up there
vont	go
donner	give
baiser	fuck
quoi	what
sauta	jumped
bas	the bottom
l'avait	had
imité	imitated
cri	cry
parvenu	managed
jusqu'au	until the
instant	now
tard	later
firent	did
irruption	burst
qu'y	what is
a-t-il	there
inquiet	worried
tu	you
pris	taken
demanda-t-il	he asked
anxieux	anxiety
écoutez-moi	listen to me
s'exclama	exclaimed
sirius	sirius
peter	peter
pettigrow	pettigrow
propre	own
l'a	the
soir	evening
faut	must
laisser	let
hocha	hocha
pâle	pale
sourire	smile
as	as
l'esprit	the spirit
embrouillé	tangled
subi	suffered
terrible	terrible
épreuve	test
allonge-toi	lay down
repose-toi	rest
l'avez	have
hurla	screamed
arrÊtÉ	stopped
s'il	if it
plaît	please
regardant	looking at
air	air
implorant	imploring
moi	me
c'était	it was
rat	rat
animagus	animagus
veux	want to
dire	say
voyez	see
intervint	intervened
savent	know
où	where
sont	are
ni	or
l'un	one
travail	work
savons	know
trÈs	very
oÙ	where
sommes	are
rugit	roars
professeur	professor
s'écria	cried
colère	anger
demander	ask
sortir	out
mon	my
malade	sick
brusquer	rush
suis	am
brusqué	harsh
passé	past
répliqua	replied
furieux	furious
seulement	only
voulaient	wanted
m'écouter	listen to me
fourra	stuffed
soudain	suddenly
bouche	mouth
l'étouffa	the choked
moitié	half
profita	took advantage
forcer	force
remettre	back
ces	these
enfants	children
besoin	need
soins	care
allez-vous-en	are you going to-
prie	pray
s'ouvrit	opened
nouveau	new
fois	time
dumbledore	dumbledore
avala	swallowed
grand-peine	great difficulty
bouchée	bite
leva	rose
l'amour	love
ciel	sky
folle	crazy
rage	rage
infirmerie	infirmary
mes	my
excuses	apologies
pompom	pompom
mot	word
mr	mr
miss	miss
très	very
calme	quiet
viens	just
parler	talk
raconté	told
conte	tale
fées	fairy
fourré	stuffed
sèchement	curtly
vivant	living
effet	effect
l'histoire	the story
m'a	me
racontée	told
admit	admitted
attentivement	carefully
travers	through
demi-lune	half-moon
témoignage	testimony
n'a	did
donc	so
importance	importance
trouvait	was
cabane	hut
hurlante	howling
n'ai	haven
trace	trace
parce	because
étiez	were
évanoui	fainted
gravement	seriously
n'êtes	there are
arrivé	arrived
entendre	hear
taire	shut up
allons	will
surpris	surprised
choc	shock
devons	must
montrer	show
indulgents	forgiving
j'aimerais	I would like to
particulier	particular
severus	severus
laissez-nous	let us
balbutia	stammered
repos	rest
désolé	sorry
peut	can
attendre	wait
j'insiste	I insist
moue	pout
indignée	outraged
retourna	returned
bureau	office
claquant	slamming
derrière	behind
consulta	consulta
grosse	big
montre	watch
or	gold
dont	which
chaîne	string
pendait	hung
gilet	vest
dû	due
arriver	getting
vais	'll
aller	go
rencontre	meeting
retrouverai	find
traversa	crossed
tint	tint
ouverte	open
celui-ci	it
bougea	moved
croyez	believe
murmura	whispered
fixement	staring
souhaite	wish
répéta	repeated
fit	fit
montré	shown
dès	as soon
l'âge	the age
seize	sixteen
ans	years
capable	able
commettre	commit
meurtre	murder
souffle	breath
j'espère	I hope
oublié	forgot
qu'un	a
jour	day
essayé	tried
tuer	kill
ma	my
mémoire	memory
fidèle	faithful
paisible	peaceful
talons	heels
franchit	crosses
fut	was
refermée	closed
mirent	started
vérité	truth
enfui	away
quand	when
lupin	lupin
changé	changed
maintenant	now
voudrais	would like to
laissiez	let
sans	without
m'interrompre	interrupt me
car	because
n'avons	have
l'ombre	the shadow
preuve	proof
confirmer	confirm
votre	your
jeunes	young
sorciers	wizards
treize	thirteen
convaincra	convince
personne	person
dizaines	tens
témoins	witnesses
juré	juror
avaient	had
moi-même	myself
certifié	certified
ministère	department
gardien	guardian
pourra	may
raconter	tell
l'interrompit	the interrupted
incapable	unable
garder	keep
longtemps	for a long time
trouve	find
actuellement	currently
plein	full
cœur	heart
forêt	forest
soit	either
quiconque	anyone
sera	will be
redevenu	again
être	be
humain	human
pire	worst
j'ajoute	I add
loups-garous	werewolves
inspirent	inspire
telle	such
méfiance	distrust
plupart	most
d'entre	of
déposition	deposition
comptera	will
vieux	old
amis	friends
Écoute-moi	Listen to me
comprends	understand
admettre	admit
version	version
convaincante	convincing
tienne	yours
déteste	hate
désespéré	desperate
cause	cause
farce	stuffing
stupide	stupid
faite	made
souvenez-vous	remember
l'attaque	the attack
dame	lady
puis	then
pénétré	penetrated
tour	tour
gryffondor	gryffindor
armé	armed
couteau	knife
modifier	edit
jugement	judgment
condamne	condemns
oui	yes
crois	believe
pouvoir	power
convaincre	convince
autres	other
d'annuler	to cancel
décisions	decisions
magie	magic
observa	watched
grave	serious
sol	soil
dérobait	stole
pieds	feet
cru	raw
pouvait	could
résoudre	solve
encore	yet
attendu	expected
solution	solution
dernier	last
espoir	hope
s'évanouissait	disappeared
faudrait	should
poursuivit	continued
lentement	slowly
bleus	blue
posèrent	laid
alternativement	alternatively
commença	started
ho	ho
s'exclama-t-elle	exclaimed she
ouvrant	opening
ronds	round
basse	low
articulant	articulating
soigneusement	carefully
flitwick	flitwick
septième	seventh
étage	floor
treizième	thirteenth
fenêtre	window
droite	right
ouest	west
passe	pass
pourrez	can
sauver	save
rappelez-vous	remember
ceci	this
l'on	we
voie	way
connaissez	know
loi	law
l'enjeu	the issue
surtout	especially
n'avait	had
passait	passed
s'approcha	approached
verrouiller	lock
minuit	midnight
cinq	five
consultant	consultant
trois	three
tours	towers
devraient	should
suffire	suffice
bonne	good
tandis	while
refermait	closing
doit	must
col	col
robe	dress
retira	retired
longue	long
fine	fine
d'or	gold
portait	wore
autour	around
cou	neck
dit-elle	she said
précipitamment	hurriedly
vite	fast
abasourdi	stunned
devant	before
alors	then
minuscule	tiny
sablier	hourglass
accroché	hung
passa	spent
prêt	loan
court	short
demanda	asked
déboussolé	disoriented
tourner	turn
s'effaça	vanished
mis	put
voler	fly
arrière	rear
vitesse	speed
vertigineuse	dizzying
tourbillon	whirlpool
couleurs	colors
formes	forms
passer	pass
sang	blood
battait	beat
oreilles	ears
essaya	tried
crier	shout
n'arrivait	there was
coup	blow
sentit	felt
vision	vision
redevint	once again
normale	normal
hall	hall
d'entrée	input
debout	standing
l'endroit	the place
désert	desert
flot	stream
lumière	light
dorée	golden
inondait	flooded
dallé	paved
regarda	looked at
effaré	aghast
s'enfonçait	sinking
chair	flesh
l'entraîna	the led
placard	closet
balais	brushes
l'ouvrit	the opened
poussa	pushed
milieu	middle
seaux	buckets
serpillières	mops
referma	closed
vas	vas
enfin	finally
m'expliquer	explain to me
remonté	reassembled
enlevant	removing
revenus	income
heures	hours
trouva	found
jambe	leg
tâtons	groping
pinça	pinched
force	force
semblait	seemed
exclure	exclude
s'agir	be
rêve	dream
particulièrement	particularly
bizarre	weird
chut	shhh
Écoute	Listening
vient	comes
colla	colla
l'oreille	the ear
contre	against
hagrid	hagrid
sûre	safe
personnes	people
marchons	walk
cape	cape
d'invisibilité	invisibility
s'interrompit	if interrupted
collée	stuck
descendre	down
l'escalier	the stairs
s'assit	sat
seau	bucket
renversé	reversed
fou	crazy
d'inquiétude	anxiety
quelques	a few
questions	questions
poser	ask
Ça	It
s'appelle	is called
retourneur	turner
chuchota	whispered
mcgonagall	mcgonagall
premier	first
rentrée	back to school
m'en	me
servie	served
l'année	the year
assister	attend
cours	during
jurer	swear
n'en	do
fallu	had to
écrive	write
lettres	letters
obtenir	get
j'étais	I was
modèle	model
servirais	hammer
études	studies
chaque	each
retournais	went back
revenais	came back
heure	time
pouvais	could
plusieurs	several
attend	waiting
pourquoi	why
revenir	return
aider	help
plongé	immersed
pénombre	penumbra
produit	product
veut	wants to
change	exchange
allés	went
pourrait	could
comprit	understood
vie	life
buck	buck
peut-il	can it
volions	flying
s'échapper	escape
grâce	thanks
pourront	can
terrifiée	terrified
arrivons	come
vus	seen
essaye	try
oreille	ear
sortirent	went out
possible	possible
cachette	cache
bruit	noise
descendirent	went down
marches	steps
menaient	led
liseré	edging
entourait	surrounded
cime	crown
arbres	trees
interdite	prohibited
ombres	shadows
s'allongeaient	grew long
d'eux	of them
regarde	look at
petite	small
aiguë	acute
jetant	throwing
d'oeil	eye
façade	facade
courir	run
droit	right
d'accord	agreement
cachera	hide
arbre	tree
regardera	look at
serres	greenhouses
depuis	since
sinon	otherwise
nous-mêmes	ourselves
près	near
chez	in
s'élança	darted
jambes	legs
suivi	follow-up
coupèrent	cut
potager	vegetable garden
jusqu'aux	up to
halte	stop
cachant	hiding
repartirent	arena
l'abri	the shelter
arriva	came to pass
d'haleine	breath
s'approche	approach
fais	do
attention	attention
te	te
avancèrent	forth
silencieusement	silently
parmi	among
suivant	following
lisière	edge
jetaient	threw
entendirent	heard
coups	shots
frappés	hit
cachèrent	hid
grand	great
chêne	oak
regardèrent	looked
prudemment	cautiously
chacun	each
tronc	trunk
venait	came
d'apparaître	to appear
tremblant	tremblant
regards	looks
frappé	hit
entendit	heard
entrer	enter
l'enlever	remove
n'auriez	would
venir	come
s'écartant	deviating
étrange	strange
impressionné	impressed
loin	far
rapprocher	closer
s'avancèrent	advanced
aperçoivent	see
l'hippogriffe	the hippogriffe
attaché	attached
clôture	closing
faisait	was
pousser	push
citrouilles	pumpkins
l'emmène	the takes
gens	people
commission	commission
libéré	released
attende	wait
l'aient	have
minute	minute
agir	act
commençait	started
l'opération	the operation
cet	this
vaisselle	dishes
brisée	broken
casse	case
pot	pot
lait	milk
trouver	find
croûtard	croûtard
minutes	minutes
surprise	surprise
précipitait	rush
attraper	catch
apeurée	frightened
violer	violate
lois	laws
importantes	important
monde	world
sorcellerie	witchcraft
changer	change
voit	see
verront	see
ferais	would
voyais	saw
brusquement	suddenly
surgir	arise
deviendrais	become
ou	or
penserais	think
noire	black
là-dessous	below
exactement	exactly
comprendrais	understand
t'attaquerais	you attaquerais
toi-même	yourself
choses	things
horribles	horrible
arrivées	arrivals
cherché	sought
certains	some
tués	killed
eux-mêmes	themselves
erreur	error
futur	future
simplement	simply
l'air	the air
donna	donna
coude	elbow
montra	showed
vieillard	old man
macnair	macnair
bourreau	executioner
descendaient	down
tarder	delay
l'arrière	the rear
compagnie	company
eût	had
éprouvée	proven
t'inquiète	don't worry
bucky	bucky
allez-y	go for it
partez	go
peuvent	can
filez	filez
déjà	already
suffisamment	enough
difficile	difficult
inutile	useless
chercher	search
ennuis	trouble
l'hermione	hermione
jeter	throw
lui-même	himself
dépêchez-vous	hurry up
n'écoutez	do not listen to
exécuteurs	executors
arrivés	arrived
volte-face	volte-face
laissant	leaving
l'herbe	the grass
s'aplatir	flatten
invisibles	invisible
s'éloignaient	go
disparu	gone
cachés	hidden
entendaient	heard
restée	remained
disait	said
l'animal	the animal
glacée	ice
dehors	outside
rauque	hoarse
cacha	hid
l'arbre	the tree
voyant	light
regarder	watch
heu	uh
lire	read
déclaration	declaration
officielle	official
concernant	on
l'exécution	the execution
serai	am
bref	brief
ensuite	then
signerez	sign
conjointement	jointly
devez	must
écouter	listen
texte	text
question	question
procédure	procedure
disparut	disappeared
attends-moi	wait for me
j'y	I
courut	ran
par-dessus	above
précipita	rushed
lisait	read
papier	paper
officiel	official
décision	decision
d'examen	review
créatures	creatures
dangereuses	dangerous
appelé	called
ci-après	below
dénommé	referred to as
condamné	sentenced
exécuté	run
date	date
6	6
juin	June
coucher	bedroom
soleil	sun
faisant	making
ciller	ciller
fixa	fixa
orange	orange
s'inclina	bowed
s'agenouilla	knelt down
releva	rose
dénouer	untie
corde	rope
l'attachait	the attached
décapitation	beheading
mise	update
œuvre	work
confiée	entrusted
désigné	designated
walden	walden
t'aider	help
doucement	gently
attesté	certified
signataires	signatories
signez	sign
tira	drew
forces	forces
pattes	legs
avant	before
plantées	planted
bouger	move
procéder	proceed
l'acte	the act
chevrotante	chevrotante
membre	member
préférable	best
restiez	stay
reste	rest
seul	only
bruits	noise
retentirent	rang
fort	fort
consentit	consented
avancer	advance
agitant	waving
ailes	wings
mauvaise	bad
humeur	mood
mètres	meters
parcourir	browse
facilement	easily
signer	sign
s'interrompirent	if stopped
claquer	slam
bec	bec
avança	advanced
livide	livid
apparut	appeared
dépêche-toi	hurry
remuant	stirring
mit	mit
contrecœur	reluctantly
atteint	reached
couvert	covered
gémit	moans
saisissant	entering
épaule	shoulder
arrête	stop
chuchota-t-il	whispered-t-he
risquent	may
grincement	grinding
indiqua	said
d'ouvrir	open
restèrent	stayed
parfaitement	perfectly
immobiles	still
est-il	is it
fureur	fury
nuance	nuance
d'amusement	fun
appela	called
sifflement	whistle
hache	axe
s'abat	down
dépit	despite
jeté	cast
instrument	instrument
percevaient	perceived
sanglots	sobs
parti	party
merveilleux	wonderful
réussir	succeed
libérer	free
bravo	bravo
magnifique	beautiful
essayer	try
rejoindre	join
solidement	securely
plantés	planted
tiraient	drew
conjuguant	combining
maintenir	maintain
immobile	still
détaché	detached
grogna	" 
devrions	should
fouiller	search
emmené	taken
croyez-vous	do you believe
voleur	thief
pied	foot
amusé	amused
vaudrait	would
mieux	better
prendrais	take
tasse	cup
thé	tea
cognac	cognac
b	b
sûr	course
bonheur	happiness
venez	come
entrez	enter
juron	curse
prononcé	pronounced
claquement	banging
revint	returned
visiblement	obviously
bouleversée	upset
d'abord	first
retournent	return
attendrons	wait
meilleur	best
jeta	threw
regard	look
profondeurs	depths
couchait	set
voulons	want to
savoir	know
déroulement	conduct
devrons	will have to
endroit	place
d'où	where
pourrons	can
saule	willow
cogneur	slugger
raison	reason
approuva	approved
restions	stay
vue	view
souviens-	remember-
toi	you
suivirent	followed
éclairés	lit
dernières	last
lueurs	light
s'arrêtèrent	stopped
bouquet	bouquet
d'arbres	trees
pouvaient	could
sombre	dark
courait	ran
pelouse	lawn
cris	cree
répercutaient	pass
écho	echo
laisse-le	let the
tranquille	quiet
va-t'en	go
silhouettes	silhouettes
surgirent	arose
plonger	dive
terre	earth
t'ai	you've
file	file
d'ici	here
sale	dirty
chat	cat
l'énorme	the huge
chien	dog
bondir	pounce
virent	saw
renverser	reverse
paraît	seems
trouves	find
entre	between
racines	roots
aïe	ouch
prendre	take
branche	branch
figure	figure
grands	great
branches	branches
essayaient	tried
d'éviter	to avoid
s'immobilisa	froze
pattenrond	pattenrond
appuie	supports
racine	root
eurent	had
gesticuler	gesticulate
instants	moments
rapprochaient	closer
retournaient	return
juste	just
descendus	down
passage	passage
venu	come
seraient	would be
venus	come
amer	bitter
parie	bet
ordonné	ordered
sur-le-champ	on-the-field
quatre	four
hommes	men
monter	mount
disparaître	disappear
environs	surrounding area
déserts	deserts
nuages	clouds
cachaient	hid
entièrement	fully
ramasser	pick up
morte	dead
servir	serve
appuyer	support
nœud	node
l'ouverture	the opening
précipitais	rushed to the
suggéra-t-il	he suggested
trouverait	would
peux-tu	can you
supporter	bear
abrupt	steep
intervenir	intervene
ajouta-t-il	he added
d'hésitation	hesitation
rattrapa	caught
pan	pan
chanter	sing
dirigeait	led
chantant	singing
tue-	kills-
démarche	approach
incertaine	uncertain
grande	great
bouteille	bottle
vois	see
tirait	drew
frénétiquement	frantically
retenir	remember
zigzag	zigzag
cessa	ceased
débattre	discuss
baissa	lowered
triste	sad
environ	about
nouvelle	new
au-dehors	outside
courant	current
direction	management
serra	serra
poings	fists
s'arrêter	stop
enlève	removes
tes	your
sales	sales
utilisée	used
immobiliser	stop
appuya	supported
soyons	let's be
ressortis	emerged
l'extrémité	the end
laquelle	which
noua	noua
proche	close
genoux	knees
n'ont-ils	have they
souviens	remember
évanouie	fainted
nombreux	many
d'elle	it
raconta	told
détraqueur	détraqueur
approché	approached
argentée	silver
arrivée	arrival
galop	gallop
obligé	forced
stupéfaite	stunned
qu'une	a
seule	only
fuir	flee
patronus	patronus
puissant	powerful
l'aurait	would have
repensait	repensait
rive	shore
opposée	opposite
lac	lake
croyait	believed
connaître	know
l'identité	the identity
était-ce	was it
suggéra	suggested
n'était	there was
fallait	had to
sorcier	sorcerer
pouvoirs	powers
puissants	powerful
chasser	hunt
brillait	shone
point	point
aurais	would have
imaginé	imagined
n'avais	had
clair	clear
avis	notice
savait	knew
allait	would
paraîtrait	would
absurde	absurd
père	father
murmura-t-il	he murmured
resta	remained
bée	eer
regardait	watched
mélange	mix
compassion	compassion
sais	know
fantôme	ghost
hallucination	hallucination
d'après	after
ressemblait	looked like
photos	photos
l'observer	watch
s'inquiétait	worried
santé	health
mentale	mental
semble	seems
dément	insane
reprit	took
creusait	digging
recherche	search
pensait	thought
lunard	lunard
queudver	queudver
patmol	patmol
cornedrue	cornedrue
trouvés	found
réapparu	reappeared
Était-il	Was it
impossible	impossible
avait-il	had he
lointaine	distant
distinctement	distinctly
certitude	certainty
l'instant	the moment
précédé	preceded
évanouissement	fainting
brise	breeze
agita	agita
feuilles	leaves
au-dessus	above
apparaissait	appeared
disparaissait	disappeared
filaient	spun
attendait	waiting
fixé	set
arrive	happens
relevèrent	raised
dressa	set
s'extraire	extract
maladroitement	awkwardly
inconscient	unconscious
flottait	floated
airs	air
dirigeaient	ran
battre	beat
rompre	break
nuage	cloud
deviné	guessed
pensées	thoughts
façon	how
pouvons	can
pourrait-on	could we
retrouver	find
noir	black
d'autre	on the other
dévoila	unveiled
minuscules	tiny
transformer	transform
répète	repeat
précipiter	rush
laissa	let
échapper	escape
terreur	terror
précipitant	precipitating
détacher	detach
peut-on	can we
cacher	hide
retourne	returns
n'est	there is
coururent	ran
tirant	pulling
hurlements	howling
volée	fly
rua	rua
verrouilla	locked
crockdur	crockdur
molosse	mastiff
aboyer	barking
bruyamment	loudly
tais-toi	tais-toi
caressant	stroking
calmer	calm down
échappé	escaped
belle	beautiful
ravi	ravi
maison	home
maître	master
s'allongea	lain
cheminée	fireplace
replia	flexed
paresseusement	lazily
prépara	prepared
somme	sum
risque	risk
soupçonneux	suspicious
promets	promise
tenterai	try
voyons	see
saurons-nous	will we know
d'aller	go
j'attends	I'm waiting for
coin	corner
ressortit	came out of it
contourna	rounded
aboiements	barking
signifiait	meant
s'approchaient	approaching
allaient	would
secours	relief
tambour	drum
poitrine	chest
celui	the
créé	created
indécis	undecided
voulait	wanted
sache	know
apparurent	appeared
arrivaient	arrived
partout	everywhere
surgissant	arising
ténèbres	darkness
glissant	sliding
long	long
rives	banks
n'aurait	would
s'approcher	approach
qu'à	as
prix	price
rapprochait	close
d'en	to
face	in the face of
voyait	saw
volutes	volutes
d'argent	money
résultat	result
propres	own
efforts	efforts
créer	create
buisson	bush
bord	edge
l'eau	the water
scrutant	peering
argentées	silver
éteintes	off
d'excitation	excitation
es-tu	are you
papa	dad
cercle	circle
relevait	was
cagoule	hood
sauveur	savior
devait	should
surgit	arises
sortit	went out
spero	spero
patronum	patronum
hurla-t-il	"he yelled,
jaillit	springs
informe	informs
animal	animal
argenté	silver
étincelait	sparkled
aveuglante	blinding
Ébloui	Dazzled
plissa	wrinkled
cheval	horse
galopait	galloped
surface	surface
baisser	lower
charger	load
grouillaient	streamed
noires	black
allongées	elongated
reculaient	stop
dispersaient	dispersed
désordre	disorder
disparaissaient	disappeared
partis	parties
revenait	back
galopant	galloping
licorne	unicorn
cerf	deer
resplendissait	there shone
s'arrêta	stopped
sabots	hooves
laissaient	let
inclina	bowed
ramure	antler
tendit	handed
tremblante	trembling
créature	creature
celle-ci	it
volatilisa	dissolved
tendue	tense
sursauta	gasped
entendant	hearing
traînant	dragging
fabriques	mills
allais	was going to
t'expliquer	explain
écouta	listened to
récit	story
t'a	you
m'as	me
écouté	listened to
n'arrive	arrives
acte	act
haut	top
niveau	level
savais	knew
réussirais	'd
l'avais	had
oh	oh
tournèrent	turned
lesquels	which
allongea	lay
inanimées	inanimate
quatrième	fourth
brancard	stretcher
lequel	which
étendu	extended
presque	almost
l'heure	the time
inquiète	concerned
quarts	quarters
d'heure	time
enferme	encloses
nos	our
lits	beds
s'aperçoive	notices
notre	our
absence	absence
attendirent	waited for
refléter	reflect
s'ennuyait	bored
recommencé	again
compter	from
fenêtres	windows
partir	from
scruta	watched
l'homme	the man
traversait	crossed
ceinture	belt
allé	gone
appui	support
courte	short
échelle	scale
grimpa	climbed
attacha	tied
collier	necklace
former	form
rênes	reins
prête	ready
tenir	take
talon	heel
flancs	sides
s'éleva	rose
serrait	tightened
grandes	large
puissamment	powerfully
cramponnée	sticking
taille	size
l'entendait	the intended
murmurer	whisper
n'aime	likes
planaient	hovering
étages	floors
supérieurs	senior
gauche	left
compta	accounting
défilaient	marching
changeait	changed
docilement	obediently
holà	whoa
ralentit	slows down
moments	moments
perdait	lost
d'altitude	altitude
regagnait	regained
accélérant	accelerating
rythme	pace
battements	beats
d'ailes	wings
pencha	bent
parvint	managed
taper	type
carreau	tile
ouvrir	open
bond	bond
l'ouvrir	the open
verrouillée	locked
reculez	back
cria	cried
alohomora	alohomora
montez	mount
fermement	firmly
hauteur	height
arrivent	arrive
s'accrocha	clung to
montants	amounts
hissa	hissa
rebord	rim
mince	thin
glisser	drag
vas-y	vas-y
secouant	shaking
monte	monte
sommet	summit
puissantes	powerful
l'altitude	the altitude
créneaux	slots
respiration	breathing
haletante	panting
patte	paw
frappait	hit
secouait	shaking
exprimer	express
impatience	impatience
guérir	heal
connaissance	knowledge
parviendra	will
fixer	fix
pourrai-je	will I be able to
remercier	thank
crièrent	cried
ensemble	all
reverrons	again
es	es
digne	worthy
fils	son
immenses	huge
mouvement	movement
emportant	taking
cavalier	jumper
s'éloigner	away
bientôt	soon
masqua	masked under
disparurent	disappeared
