13	13
gryffondor	gryffindor
contre	against
serdaigle	ravenclaw
il	it
semblait	seemed
que	that
c'en	it
était	was
fini	finished
de	of
l'amitié	the friendship
entre	between
ron	ron
et	and
hermione	hermione
chacun	each
si	if
furieux	furious
l'autre	the other
harry	harry
ne	do
voyait	saw
pas	not
comment	how
ils	they
pourraient	could
jamais	never
se	is
réconcilier	reconcile
qu'hermione	as hermione
n'ait	did
pris	taken
au	the
sérieux	serious
les	the
tentatives	attempts
pattenrond	pattenrond
dévorer	devour
croûtard	croûtard
elle	it
n'avait	had
fait	fact
l'effort	the effort
le	the
surveiller	monitor
près	near
maintenant	now
encore	yet
prétendait	claimed
innocent	innocent
ferait	would
bien	well
d'aller	go
voir	see
cachait	hid
sous	under
un	a
lit	bed
affirmait	said
sans	without
en	in
démordre	believe me
incapable	unable
prouver	prove
avait	had
mangé	ate
d'après	after
poils	hair
du	the
chat	cat
trouvaient	were
peut-être	maybe
là	there
depuis	since
noël	christmas
d'ailleurs	moreover,
affirmait-elle	said she
toujours	always
eu	had
préjugé	prejudice
jour	day
où	where
lui	him
sauté	skipped
dessus	top
dans	in
la	the
ménagerie	menagerie
magique	magic
convaincu	convinced
bel	beautiful
dévoré	devoured
lorsqu'il	when it
fit	fit
valoir	submitted
à	to
tous	all
indices	indices
tendaient	tended
fâcha	angry
également	also
tu	you
prends	take
parti	party
pour	for
très	very
toute	any
façon	how
j'en	I
étais	was
sûre	safe
s'écria-t-elle	cried she
d'une	a
voix	voice
perçante	piercing
d'abord	first
l'Éclair	the Flash
feu	fire
ensuite	then
tout	all
est	is
ma	my
faute	fault
entendu	heard
me	me
laissais	let
tranquille	quiet
j'ai	I
beaucoup	a lot
travail	work
faire	do
été	been
affecté	affected
par	by
perte	loss
son	its
rat	rat
allons	will
souviens-toi	remember
n'arrêtais	just kept
répéter	repeat
terriblement	terribly
ennuyeux	boring
dit	said
fred	fred
ça	it
une	a
éternité	eternity
qu'il	it
patraque	woozy
bout	end
rouleau	roll
c'est	it is
doute	doubt
bonne	good
chose	thing
d'en	to
avoir	have
rapidement	quickly
n'a	did
dû	due
qu'une	a
bouchée	bite
sûrement	surely
rien	nothing
senti	felt
s'indigna	grew indignant
ginny	ginny
ce	this
savait	knew
c'était	it was
manger	eat
dormir	sleep
l'as	the ace
toi-même	yourself
ajouta	added
george	george
nous	we
a	has
débarrassés	rid
goyle	goyle
mordant	biting
répliqua	replied
d'un	a
air	air
accablé	overwhelmed
te	te
souviens	remember
vrai	true
heure	time
gloire	glory
garder	keep
cicatrice	scar
sur	on
doigt	finger
témoigne	witness
cet	this
acte	act
bravoure	bravery
allez	go
va	will
donc	so
tour	tour
pré-au-lard	pre-to-bacon
achète-toi	buy yourself
nouveau	new
quoi	what
sert	serves
lamenter	lament
ultime	ultimate
tentative	attempt
remonter	back
moral	moral
proposa	proposed
d'assister	to attend
dernière	last
séance	session
d'entraînement	training
avant	before
match	match
comme	as
pourrait	could
essayer	try
lorsqu'ils	when they
auraient	would
enthousiasmé	excited
cette	this
idée	idea
oublia	forgot
pendant	during
moment	time
l'emmena	took it to
aussitôt	as soon
terrain	field
quidditch	quidditch
madame	mrs.
bibine	booze
qui	that
continuait	continued
aux	the
entraînements	workouts
veiller	ensure
fut	was
aussi	also
impressionnée	impressed
autres	other
prit	took
main	hand
joueurs	players
décollent	take off
bénéficier	benefit
ses	its
commentaires	comments
professionnelle	professional
regardez	watch
merveilleux	wonderful
équilibre	balance
nimbus	nimbus
ont	have
défaut	default
tendance	trend
pencher	look
peu	little
vers	to
l'arrière	the rear
quelques	a few
années	years
perdent	lose
vitesse	speed
voyez	see
redessiné	redesigned
poignée	handle
plus	more
fine	fine
brossdur	brossdur
penser	think
anciennes	old
flèches	arrows
d'argent	money
–	-
tellement	so
dommage	damage
qu'ils	they
aient	have
arrêté	stopped
fabrication	manufacturing
je	I
appris	learned
voler	fly
l'un	one
d'eux	of them
vraiment	really
balai	broom
remarquable	remarkable
continua	continued
ainsi	as well
certain	some
temps	time
jusqu'à	up to
dubois	dubois
finisse	finish
s'impatienter	getting impatient
dit-il	he said
est-ce	is this
récupérer	recover
faudrait	should
qu'on	we
commence	begins
l'entraînement	training
oh	oh
mais	but
sûr	course
allez-y	go for it
potter	potter
rendant	making
alla	alla
s'asseoir	sit
gradins	bleachers
compagnie	company
l'équipe	the team
rassemblait	together
autour	around
capitaine	captain
écouter	listen
dernières	last
instructions	instructions
viens	just
d'apprendre	to learn
cho	cho
chang	chang
jouer	play
attrapeur	monkey net
chez	in
quatrième	fourth
année	year
joueuse	player
s'est	is
blessée	injured
récemment	recently
j'espérais	I was hoping
qu'elle	it
serait	would be
disponible	available
malheureusement	unfortunately
fronça	frowned
sourcils	eyebrows
visiblement	obviously
contrarié	upset
eût	had
guéri	healed
vite	fast
l'avantage	the advantage
reprit-il	"he said
comète	comet
260	260
c'est-à-dire	that is to say,
plaisanterie	joke
rapport	report
bon	good
allons-y	let's go
première	first
fois	time
put	put
enfin	finally
enfourcher	ride
Éclair	Flash
décoller	take off
mieux	better
pu	could
imaginer	imagine
moindre	less
caresse	caress
l'eclair	the lightning
virait	making a turn
avec	with
précision	precision
incomparable	incomparable
s'il	if it
obéi	obeyed
pensées	thoughts
plutôt	rather
qu'à	as
gestes	gestures
traversa	crossed
telle	such
stade	stage
transforma	transformed
mélange	mix
confus	confused
teinté	tinted
vert	green
gris	grey
virage	turn
serré	tight
qu'alicia	that alicia
spinnet	spinnet
poussa	pushed
cri	cry
terreur	terror
puis	then
descendit	went down
piqué	stung
frôler	graze
l'herbe	the grass
des	of
pieds	feet
chandelle	candle
hauteur	height
quinze	fifteen
mètres	meters
lâche	loose
vif	bright
d'or	gold
cria	cried
vira	vira
course	race
cognard	cognard
n'eut	had
aucun	no
mal	evil
dépasser	exceed
vit	lives
alors	then
filer	spinning
airs	air
mit	mit
dix	ten
secondes	seconds
l'attraper	the catch
creux	hollow
sa	its
acclamations	cheers
enthousiastes	enthusiastic
coéquipiers	teammates
retentirent	rang
relâcha	released
laissa	let
prendre	take
minute	minute
d'avance	advance
lança	launched
poursuite	further
faufilant	weaving
repéra	spotted
genou	knee
katie	katie
bell	bell
fondit	burst
contourna	rounded
aisément	easily
attrapa	caught
leur	their
meilleure	best
galvanisée	galvanized
présence	presence
surpassa	surpassed
lorsque	when
monde	world
redescendu	come back down
pelouse	lawn
n'adressa	not addressed
critique	critical
remarquer	notice
weasley	weasley
vois	see
arrêter	stop
demain	tomorrow
s'exclama	exclaimed
moins	less
as	as
réglé	set
ton	your
problème	problem
détraqueurs	détraqueurs
oui	yes
répondit	replied
pensant	thinking
maigre	lean
patronus	patronus
aurait	would
souhaité	desired
consistant	consisting of
reviendront	return
olivier	olivier
dumbledore	dumbledore
fou	crazy
assura	assura
espérons	hope
raison	reason
cas	case
vous	you
avez	have
on	it
retourne	returns
château	castle
couchez-vous	lie
reste	rest
voudrait	would like to
tandis	while
rentraient	returning
vestiaire	cloakroom
rejoindre	join
s'était	had
endormie	sleepy
gradin	gradin
vas-y	vas-y
tendant	for
expression	expression
extatique	ecstatic
visage	face
enfourcha	enfourcha
s'éleva	rose
crépuscule	twilight
regard	look
s'éveilla	woke
sursaut	startle
nuit	night
tombée	fallen
furieuse	furious
l'aient	have
réveillée	woke up
insista	insisted
rentrent	return
immédiatement	immediately
l'épaule	the shoulder
quitta	left
deux	two
rivalisant	competing
d'éloges	praise
performances	performance
étaient	were
mi-chemin	mid-way
aperçut	saw
soudain	suddenly
gauche	left
quelque	some
l'effet	the effect
coup	blow
poing	fist
l'estomac	the stomach
paire	pair
d'yeux	eyes
brillaient	shone
l'obscurité	the dark
figea	froze
place	place
cœur	heart
battant	flying
rompre	break
qu'est-ce	what is this
y	there
s'étonna	was surprised
tendit	handed
sortit	went out
baguette	wand
murmura	whispered
lumos	lumos
rayon	radius
lumière	light
traça	drew
sillon	furrow
illumina	illumina
arbre	tree
accroché	hung
branche	branch
tenait	held
l'affût	the lookout
fiche	sheet
camp	camp
toi	you
rugit	roars
pencha	bent
ramasser	pick up
pierre	stone
ait	has
soit	either
disparu	gone
éclair	flash
orangé	orange
vu	seen
laissant	leaving
tomber	fall
laisse	leaves
aller	go
veut	wants to
croquer	chewable
ou	or
oiseaux	birds
guise	as
dessert	dessert
après	after
resta	remained
silencieux	silent
contenta	contenta
pousser	push
long	long
soupir	sigh
soulagement	relief
instant	now
cru	raw
ces	these
yeux	eyes
brillants	brilliant
ceux	those
sinistros	sinistros
reprirent	resumed
chemin	path
honteux	shameful
s'être	will be
laissé	left
panique	panic
garda	garda
fixés	set
droit	right
devant	before
atteint	reached
rassurante	reassuring
hall	hall
d'entrée	input
lendemain	next day
petit	small
déjeuner	breakfast
camarades	comrades
dortoir	dormitory
estimaient	felt
méritait	deserved
sorte	so
garde	guard
d'honneur	of honor
entra	entered
grande	great
salle	room
regards	looks
tournèrent	turned
murmures	whispers
s'élevèrent	rose
toutes	all
parts	units
constata	found
satisfaction	satisfaction
serpentard	slytherin
paraissaient	seemed
foudroyés	storm
tête	head
ravi	ravi
retournant	returning
malefoy	malfoy
l'air	the air
croire	believe
parfait	perfect
prenait	took
part	share
s'attachait	attached
mets-le	put the
ici	here
posant	posing
milieu	middle
table	table
nom	name
marque	brand
visible	visible
élèves	students
poufsouffle	hufflepuff
s'approchèrent	came
contempler	contemplate
l'objet	the object
cedric	cedric
diggory	diggory
vint	came
féliciter	congratulate
d'avoir	to have
avantageusement	advantageously
remplacé	replaced
2000	2000
pénélope	penelope
deauclaire	deauclaire
petite	small
amie	friend
percy	percy
demanda	asked
permission	permission
mains	hands
attention	attention
sabotage	sabotage
amusé	amused
examinait	examined
moi	me
pari	bet
expliqua-t-il	he explained
gallions	galleons
résultat	result
reposa	rested
remercia	thanked
retourna	returned
débrouille-toi	you're on your own
gagner	win
chuchota	whispered
précipitamment	hurriedly
n'ai	haven
j'arrive	I can
penny	penny
courut	ran
partager	share
toast	toast
es	es
sauras	'll know
piloter	drive
traînante	shuffling
glaciale	icy
drago	drago
approché	approached
jeter	throw
d'oeil	eye
suivi	follow-up
crabbe	crabbe
pense	think
dégagé	loose
d'accessoires	accessories
n'est-ce	is this
pétillants	sparkling
malveillance	malice
parachute	parachute
détraqueur	détraqueur
passerait	would
ricanèrent	ricanèrent
puisses	can
greffer	graft
troisième	third
bras	arm
attraper	catch
ta	your
éclatèrent	burst
rire	laugh
sonore	sound
plissa	wrinkled
petits	small
délavés	faded
tourna	turned
talons	heels
rejoignit	joined
rassembla	together
demander	ask
véritable	true
onze	eleven
heures	hours
quart	quarter
prirent	took
direction	management
vestiaires	locker rooms
complètement	completely
changé	changed
ciel	sky
présent	this
clair	clear
frais	fees
brise	breeze
soufflait	blew
instants	moments
n'y	there
visibilité	visibility
malgré	despite
trac	trac
ressentait	felt
l'excitation	the excitement
seule	only
perspective	perspective
pouvait	could
provoquer	cause
poudlard	hogwarts
envahissaient	invaded
ôta	took off
robe	dress
noire	black
glissa	slipped
t-shirt	t-shirt
espérant	hoping
forces	forces
n'aurait	would
s'en	in
servir	serve
professeur	professor
lupin	lupin
tribunes	forums
savez	know
furent	were
prêts	loans
quitter	leave
perdons	lose
serons	will be
soyez	be
d'hier	yesterday
ira	ira
entrèrent	went
public	public
vêtus	dressed
bleu	blue
déjà	already
jouait	played
poste	post
d'attrapeur	of monkey net
fille	girl
équipe	team
celui-ci	it
nervosité	nervousness
manqua	missed
constater	see
particulièrement	particularly
jolie	pretty
équipes	teams
firent	did
face	in the face of
alignées	aligned
derrière	behind
leurs	their
capitaines	captains
adressa	addressed
sourire	smile
donna	donna
étrange	strange
sensation	sensation
davies	davies
serrez-vous	tighten
serra	serra
enfourchez	hop on
vos	your
balais	brushes
mon	my
sifflet	whistle
trois	three
décolla	took off
fila	fila
haut	top
amorça	started
commença	started
chercher	search
écoutant	listening to
commentaire	comment
assuré	insured
lee	lee
jordan	jordan
ami	friend
Ça	It
clou	nail
monté	mounted
l'on	we
croit	believes
balai-magazine	broom-magazine
choisi	chosen
nationales	national
participeront	will
championnat	championship
voudriez	would like to
commenter	comment
passe	pass
l'interrompit	the interrupted
mcgonagall	mcgonagall
donnais	gave
simplement	simply
nouvelles	new
signalons	note
passage	passage
équipé	equipped
frein	brake
automatique	automatic
intégré	built-in
l'attaque	the attack
rapproche	closer
buts	goals
adverses	adverse
l'œil	the eye
aguets	watch
prêt	loan
agir	act
scintillement	flicker
doré	golden
croisa	crossed
pleine	full
remarqua	noticed
suivait	followed
volait	flying
d'habileté	skill
coupant	cutting
cesse	stops
trajectoire	path
l'obliger	the force
changer	change
montre-lui	watch him
tes	your
accélérations	acceleration
fonçant	darkening
alicia	alicia
cible	target
puissance	power
suivre	follow
marquait	marked
premier	first
but	purpose
déchaînant	unleashing
l'aperçut	the saw
sol	soil
voletant	flitting
proximité	close
barrière	barrier
plongea	dove
changement	change
fonça	rushed
surexcité	excited
accéléra	accelerated
fond	background
descentes	descents
spécialités	specialties
n'était	there was
renvoyé	returned
batteur	drummer
surgit	arises
catastrophe	disaster
réussit	successful
l'éviter	avoid
d'extrême	extreme
justesse	accuracy
mis	put
profit	profit
disparaître	disappear
eut	had
grand	great
oooooooh	oooooooh
déception	disappointment
parmi	among
supporters	supporters
nombreux	many
applaudissements	applause
saluer	greet
joli	nice
libre	free
cours	during
mauvaise	bad
humeur	mood
renvoyant	referring
deuxième	second
adverse	opposing
dut	otc
tonneau	barrel
mène	leads
quatre-vingts	eighty
points	points
zéro	zero
arrive	happens
prend	takes
virages	turns
poids	weight
reÇu	received
l'argent	the money
publicitÉ	advertising
concentrez-vous	focus
rattrapait	just catching up
retard	delay
marqué	marked
réduisait	reduced
l'avance	advance
cinquante	fifty
attrapait	caught
gagnerait	would
jetait	cast
frénétiques	frantic
reflet	reflection
battement	beat
d'ailes	wings
minuscules	tiny
contournait	skirting
point	point
tard	later
travers	through
n'est	there is
d'Être	to Be
galant	galant
faisait	was
embardée	swerve
éviter	avoid
collision	collision
fais-la	do the
faut	must
jeta	threw
souriait	smiling
l'altitude	the altitude
plusieurs	several
coin	corner
décidé	decided
calquer	match
sienne	siena
elle-même	itself
tant	as
devrait	should
subir	undergo
conséquences	consequences
croyant	believing
repéré	spotted
essaya	tried
remonta	came up
brusquement	suddenly
poursuivant	continuing
lancée	launched
foncer	create
boulet	boulet
brillait	shone
loin	far
au-dessus	above
côté	side
trouvait	was
altitude	altitude
inférieure	lower
gagnait	won
s'écria	cried
montrant	showing
bas	the bottom
encagoulés	hooded
capes	capes
noires	black
regardaient	watched
n'hésita	do not hesitate
plongeant	plunging
hurler	scream
spero	spero
patronum	patronum
forme	form
argentée	silver
gigantesque	gigantic
jaillit	springs
l'extrémité	the end
visé	referred to
directement	directly
regarder	watch
passait	passed
miracle	miracle
resté	stayed
lucide	lucid
presque	almost
rattrapé	caught up
lâcher	letting go
parvint	managed
refermer	close
doigts	fingers
balle	ball
ailée	winged
essayait	tried
vain	vain
échapper	escape
retentit	sounds
sens	meaning
inverse	reverse
demi-douzaine	a half-dozen
silhouettes	silhouettes
écartâtes	écartâtes
fonçaient	rushed
six	six
l'étreignirent	the étreignirent
force	force
faillit	almost
montant	amount
entendit	heard
type	type
formidable	great
répétait	repeated
pleins	full
poumons	lungs
angelina	angelina
avaient	had
embrassé	kissed
fort	fort
n'allait	did
arracher	snatch
totale	total
confusion	confusion
atterrir	land
nuée	cloud
englouti	engulfed
foule	crowd
déchaînée	unleashed
bravo	bravo
hurla	screamed
levant	rising
magnifique	beautiful
vais	'll
excuse-moi	excuse me
j'aille	I go
extraordinaire	extraordinary
seamus	seamus
finnigan	finnigan
hagrid	hagrid
dont	which
dépassait	exceeded
l'oreille	the ear
paraissait	seemed
ébranlé	shaken
content	content
m'ont	I have
ressenti	felt
parce	because
n'étaient	there were
venez	come
emmena	took
jusqu'au	until the
bord	edge
peur	fear
mr	mr
marcus	marcus
flint	flint
allongés	elongated
terre	earth
uns	each
empêtrés	entangled
longues	long
cagoules	hoods
assorties	assorted
essayaient	tried
débarrasser	rid
tombés	fallen
épaules	shoulders
d'intense	intense
fureur	fury
eux	them
stratagème	ploy
lamentable	sorry
hurla-t-elle	screamed she
abjecte	abject
déstabiliser	destabilize
l'attrapeur	the monkey net
aurez	will
retenue	withholding
j'enlève	I take off
certains	some
parlerai	talk about
histoire	history
ah	ah
justement	precisely
voilà	this is
couronner	top
victoire	victory
rejoint	joined
côtes	coast
regardant	looking at
empêtré	entangled
cape	cape
n'arrivait	there was
même	even
sortir	out
fête	feast
commune	common
longtemps	for a long time
heureux	happy
accompagné	accompanied
robes	dresses
écarlates	scarlet
s'ils	if they
gagné	won
coupe	cup
dura	dura
journée	day
prolongea	extended
avancée	advanced
disparurent	disappeared
revinrent	returned
chargés	loaded
bouteilles	bottles
bièraubeurre	bièraubeurre
soda	soda
citrouille	pumpkin
sacs	bags
friandises	treats
honeydukes	honeydukes
johnson	johnson
aiguë	acute
distribuait	distributed
crapauds	toads
menthe	mint
avons	have
aidés	helped
lunard	lunard
queudver	queudver
patmol	patmol
cornedrue	cornedrue
personne	person
refusé	refused
joindre	join
festivités	festivities
inexplicablement	inexplicably
restait	remained
assise	sitting
lire	read
énorme	huge
volume	volume
intitulé	title
vie	life
mœurs	morals
moldus	muggle
grande-bretagne	great britain
s'approcha	approached
d'elle	it
venue	coming
demanda-t-il	he asked
étrangement	strangely
lever	sunrise
livre	book
suis	am
heureuse	happy
ayons	have
trouve	find
joué	played
dois	do
lundi	Monday
boire	drink
jetant	throwing
d'œil	eye
d'humeur	mood
enterrer	bury
hache	axe
guerre	war
impossible	impossible
quatre	four
cent	cent
vingt-deux	twenty-two
pages	pages
crise	crisis
nerfs	nerves
ajouta-t-elle	"she added,
fasse	do
mettre	put
fin	end
conciliation	conciliation
choisit	chooses
précis	specific
lancer	launch
haute	high
aimé	loved
bonbons	candy
larmes	tears
dire	say
referma	closed
l'énorme	the huge
monta	went up
l'escalier	the stairs
menait	led
filles	girls
peux	can
laisser	let
basse	low
non	not
regretter	regret
passé	past
voudra	want to
avouer	confess
tort	wrong
continue	continues
comporter	include
vacances	holiday
matin	morning
apparut	appeared
chambre	room
écossaise	scottish
cheveux	hair
recouverts	covered
filet	net
exiger	require
aille	go
coucher	bedroom
Épuisé	Exhausted
soigneusement	carefully
fermé	closed
rideaux	curtains
baldaquin	canopy
s'endormit	fell asleep
rêve	dream
marchait	walked
forêt	forest
suivant	following
blanc	white
argenté	silver
faufilait	faufilait
arbres	trees
n'apercevait	not found
feuillage	foliage
hâtait	hastening
rattraper	catch up
insolite	unusual
celle-ci	it
accélérait	accelerating
l'allure	the look
mettait	put
courir	run
entendait	heard
sabots	hooves
martelaient	martelaient
rythme	pace
rapide	fast
bientôt	soon
courait	ran
jambes	legs
retentissait	there was a tremendous burst
galop	gallop
effréné	frantic
arrivait	arrived
clairière	glade
aaaaaaaaaaaaaaaaaaaaarrrrrrr-	aaaaaaaaaaaaaaaaaaaaarrrrrrr-
rrrrrrrrrrgggggggggggggggghhhhhhhhhhhhhhhhhhhhhh	rrrrrrrrrrgggggggggggggggghhhhhhhhhhhhhhhhhhhhhh
noooooooooooooooooooooonnnnnnnnnnn	noooooooooooooooooooooonnnnnnnnnnn
réveilla	woke up
venait	came
donner	give
gifle	slap
obscurité	darkness
chercha	sought
tâtons	groping
mouvements	movements
pièce	room
crut	believed
entendre	hear
claquer	slam
porte	door
écarter	aside
dean	dean
thomas	thomas
alluma	lit
lampe	lamp
assis	sitting
déchirés	torn
black	black
sirius	sirius
couteau	knife
l'instant	the moment
déchiré	torn
m'a	me
réveillé	woke up
n'as	did
cauchemar	nightmare
regarde	look at
dis	say
sortirent	went out
lits	beds
atteindre	reach
dévalèrent	dévalèrent
portes	doors
s'ouvraient	opened
ensommeillées	ensommeillées
s'élevaient	amounted
crié	shouted
fabriquez	make
éclairée	lit
braises	embers
rougeoyaient	rougeoyaient
cheminée	fireplace
déserte	deserted
rêvé	dreamed
l'ai	I
vacarme	din
descendues	descended
enfilant	threading
ensommeillé	sleepy
garçons	boys
arrivaient	arrived
nombre	number
réjoui	pleased
dortoirs	dormitories
épinglant	pinning
insigne	badge
préfet-en-chef	prefect-in-chief
revers	reverse
pyjama	pajamas
faible	low
silence	silence
s'installa	settled
absurde	absurd
déconcerté	baffled
trop	too
suffit	just
arriva	came to pass
s'avança	advanced
lançant	launching
enchantée	enchanted
dit-elle	she said
cela	this
devient	becomes
ridicule	ridiculous
j'attendais	I was expecting
votre	your
absolument	absolutely
autorisé	authorized
vient	comes
passer	pass
bombant	dishing
torse	torso
indigné	indignant
j'étais	I was
train	train
frère	brother
n'Était	there Was
reveillÉ	moment of concern
À	To
regarda	looked at
fixement	staring
aurait-il	would it
franchir	cross
portrait	portrait
pointant	pointing
index	index
tremblant	tremblant
chevalier	knight
catogan	catogan
demandez-lui	ask him
lancé	launched
soupçonneux	suspicious
repoussa	pushed
tableau	table
masquait	masked
l'entrée	the entry
couloir	hallway
retint	retained
souffle	breath
avez-vous	have you
entrer	enter
homme	man
gente	gente
dame	lady
stupéfait	stunned
mot	word
fièrement	proudly
semaine	week
Écrits	Written
morceau	song
papier	paper
lus	read
rentra	returned
abasourdis	stunned
livide	livid
frémissante	simmering
assez	enough
stupide	stupid
noter	note
mots	words
traîner	hanging out
n'importe	any
total	total
rompu	broken
apeuré	frightened
neville	neville
londubat	londubat
leva	rose
lentement	slowly
