15	15
la	the
finale	final
de	of
quidditch	quidditch
il	it
m'a	me
envoyé	sent
ça	it
dit	said
hermione	hermione
en	in
leur	their
tendant	for
lettre	letter
harry	harry
prit	took
le	the
parchemin	parchment
sur	on
lequel	which
elle	it
était	was
écrite	written
humide	wet
et	and
une	a
énorme	huge
larme	tear
avait	had
tellement	so
dilué	diluted
l'encre	the ink
par	by
endroits	places
qu'elle	it
devenue	become
très	very
difficile	difficult
à	to
lire	read
chère	dear
nous	we
avons	have
perdu	lost
j'ai	I
eu	had
l'autorisation	the authorization
ramèner	ramèner
poudlard	hogwarts
date	date
l'exécution	the execution
sera	will be
bientôt	soon
fixée	fixed
buck	buck
a	has
beaucoup	a lot
aimé	loved
londres	london
je	I
n'oublierai	do not forget
pas	not
toute	any
l'aide	using
que	that
tu	you
m'as	me
apportée	made
hagrid	hagrid
ils	they
ne	do
peuvent	can
quand	when
même	even
faire	do
c'est	it is
impossible	impossible
n'est	there is
dangereux	dangerous
père	father
malefoy	malfoy
intimidé	intimidated
les	the
membres	members
commission	commission
s'essuyant	wiping
yeux	eyes
sais	know
comment	how
est	is
y	there
bande	band
vieux	old
gâteux	gâteux
là-dedans	there
ont	have
peur	fear
va	will
avoir	have
un	a
appel	call
bien	well
sûr	course
toujours	always
mais	but
vois	see
aucun	no
espoir	hope
rien	nothing
n'aura	will
changé	changed
d'ici	here
là	there
si	if
changer	change
ron	ron
d'un	a
air	air
féroce	fierce
cette	this
fois	time
n'auras	there will
travail	work
seule	only
vais	'll
t'aider	help
oh	oh
lui	him
sauta	jumped
au	the
cou	neck
fondit	burst
larmes	tears
l'air	the air
terrifié	terrified
tapota	tapped
maladroitement	awkwardly
tête	head
finit	ends
desserrer	loosen
son	its
étreinte	hug
suis	am
vraiment	really
désolée	sorry
pour	for
croûtard	croûtard
sanglota-t-elle	sanglota-t-it
façon	how
répondit	replied
visiblement	obviously
soulagé	relieved
l'ait	has
enfin	finally
lâché	let go
servait	served
grand-chose	much
maintenant	now
on	it
sait	knows
jamais	never
peut-être	maybe
mes	my
parents	parents
vont	go
m'acheter	buy me
hibou	owl
mesures	measures
sécurité	security
imposées	imposed
aux	the
élèves	students
depuis	since
seconde	second
intrusion	intrusion
black	black
interdisaient	prohibited
rendre	make
visite	visit
fin	end
journée	day
possibilité	possibility
qu'ils	they
avaient	had
parler	talk
c'était	it was
pendant	during
cours	during
soins	care
créatures	creatures
magiques	magic
verdict	verdict
semblait	seemed
l'avoir	have
assommé	knocked out
ma	my
faute	fault
n'osais	dared
étaient	were
tous	all
assis	sitting
dans	in
leurs	their
robes	dresses
noires	black
n'arrêtais	just kept
me	me
perdre	lose
notes	notes
d'oublier	forget
dates	dates
m'avais	I had
données	data
ensuite	then
lucius	lucius
s'est	is
levé	survey
prononcé	pronounced
discours	speech
obéi	obeyed
doigt	finger
l'œil	the eye
reste	rest
recours	use
combatif	fighting
faut	must
abandonner	abandon
s'y	there
mettre	put
lorsqu'ils	when they
rentrèrent	returned
château	castle
avec	with
autres	other
virent	saw
qui	that
marchait	walked
devant	before
eux	them
accompagné	accompanied
crabbe	crabbe
goyle	goyle
se	is
retournant	returning
temps	time
autre	other
sourire	smile
narquois	mocking
terrible	terrible
tristement	sadly
pied	foot
des	of
marches	steps
menaient	led
l'entrée	the entry
du	the
tient	holds
creux	hollow
sa	its
main	hand
tout	all
ce	this
peux	can
essayer	try
plus	more
heureux	happy
possible	possible
qu'il	it
vivre	live
dois	do
moins	less
tourna	turned
talons	heels
hâta	haste
regagner	return
cabane	hut
visage	face
enfoui	buried
mouchoir	handkerchief
regarde-le	look at the
pleurnicher	whining
restés	stayed
porte	door
écouter	listen
conversation	conversation
vu	seen
type	type
aussi	also
lamentable	sorry
censé	supposed to
être	be
professeur	professor
école	school
s'avancèrent	advanced
vers	to
menaçant	threatening
fut	was
rapide	fast
clac	clac
toutes	all
ses	its
forces	forces
gifla	slapped her
vacilla	wavered
sous	under
choc	shock
stupéfaits	stunned
regardèrent	looked
lever	sunrise
nouveau	new
t'avise	you shall notify
traiter	treat
espèce	species
sale	dirty
petit	small
bonhomme	man
voix	voice
basse	low
essayant	trying
attraper	catch
avant	before
gifle	slap
laisse-moi	let me
sortit	went out
baguette	wand
magique	magic
recula	backed
tandis	while
regardaient	watched
décontenancés	puzzled
attendant	waiting
instructions	instructions
venez	come
marmonna	muttered
instant	now
tard	later
trois	three
disparu	gone
sous-sols	sub-soil
répéta	repeated
ton	your
mêlait	mixed
étonnement	astonishment
admiration	admiration
as	as
intérêt	interest
battre	beat
jour	day
lança	launched
d'une	a
perçante	piercing
parce	because
serpentard	slytherin
gagne	wins
supporterai	enduring
sortilèges	spells
continuait	continued
regarder	watch
ronds	round
ferait	would
d'y	there
aller	go
montèrent	went up
alors	then
l'escalier	the stairs
marbre	marble
direction	management
classe	class
flitwick	flitwick
vous	you
êtes	are
retard	delay
réprobateur	réprobateur
lorsque	when
ouvrit	opened
salle	room
dépêchez-vous	hurry up
d'entrer	to enter
sortez	get out
vos	your
baguettes	chopsticks
aujourd'hui	today
étudions	study
d'allégresse	joy
sommes	are
déjà	already
regroupés	grouped
équipes	teams
deux	two
précipitèrent	ran
table	table
fond	background
ouvrirent	opened
sacs	bags
regarda	looked at
derrière	behind
où	where
passée	past
s'étonna-t-il	was surprised there
n'était	there was
entrée	entry
pourtant	yet
trouvait	was
côté	side
lorsqu'il	when it
ouvert	open
bizarre	weird
dit-il	he said
regardant	looking at
interrogateur	interrogator
allée	alley
toilettes	toilet
montra	showed
Ça	It
aurait	would
fait	fact
sortilège	hex
quittèrent	left
déjeuner	breakfast
procuré	provided
durable	sustainable
sensation	sensation
contentement	contentment
non	not
eurent	had
terminé	finished
dessert	dessert
effets	effects
dissipèrent	dispersed
commencèrent	started
s'inquiéter	worry
crois	believe
pu	could
quelque	some
chose	thing
demanda	asked
anxieux	anxiety
dépêchèrent	dispatched
retourner	return
tour	tour
gryffondor	gryffindor
passèrent	passed
trolls	trolls
donnèrent	gave
mot	word
passe	pass
grosse	big
dame	lady
commune	common
assise	sitting
posée	asked
livre	book
d'arithmancie	of arithmancie
profondément	deeply
endormie	sleepy
vinrent	came
s'asseoir	sit
côtés	sides
secoua	shook
légèrement	slightly
l'épaule	the shoulder
réveiller	wake up
qu	that
quoi	what
balbutia	stammered
redressant	straightening
brusquement	suddenly
affolé	panic-stricken
l'heure	the time
qu'est-ce	what is this
qu'on	we
comme	as
divination	divination
vingt	twenty
minutes	minutes
t'ait	have you
vue	view
s'exclama-t-elle	exclaimed she
oublié	forgot
s'étonna	was surprised
étais	was
jusqu'à	up to
arrive	happens
n'arrive	arrives
croire	believe
gémit	moans
devait	should
furieux	furious
contre	against
moi	me
cause	cause
mise	update
colère	anger
savais	knew
j'en	I
l'énorme	the huge
servi	served
d'oreiller	pillow
es	es
surmenée	overwrought
fais	do
trop	too
certainement	certainly
protesta	protested
écartant	apart
cheveux	hair
tombaient	fell
simplement	simply
trompée	wrong
voir	see
dire	say
retrouverai	find
rejoignit	joined
l'échelle	the scale
menait	led
trelawney	trelawney
exaspérée	exasperated
j'aie	I have
manquer	miss
sûre	safe
examens	reviews
l'avait	had
laissé	left
entendre	hear
ensemble	all
petite	small
étouffante	stifling
plongée	diving
pénombre	penumbra
chaque	each
brillait	shone
boule	ball
cristal	crystal
remplie	filled
fumée	smoke
blanche	white
s'assirent	sat
délabrée	dilapidated
croyais	thought
boules	balls
prochain	next
trimestre	quarter
murmura	whispered
jetant	throwing
coup	blow
d'œil	eye
prudent	careful
autour	around
cachait	hid
part	share
te	te
plains	plains
veut	wants to
fini	finished
lignes	lines
avais	had
assez	enough
s'évanouir	vanish
moitié	half
regardait	watched
ligne	line
vie	life
bonjour	hello
familière	familiar
mystérieuse	mysterious
émergea	emerged
l'ombre	the shadow
habitude	usual
parvati	parvati
lavande	lavender
frémirent	rustled
d'excitation	excitation
baigné	bathed
lueur	glow
laiteuse	milky
projetait	projected
décidé	decided
commencer	start
l'étude	the study
peu	little
tôt	early
l'avais	had
prévu	expected
s'asseyant	sitting
feu	fire
brûlait	burned
cheminée	fireplace
signes	signs
destin	destiny
m'ont	I have
informée	informed
votre	your
examen	review
d'année	of the year
portera	will
sphère	sphere
tiens	want
soyez	be
préparés	prepared
l'ont	have
est-ce	is this
décide	decides
sujet	about
l'exame	the certi
parles	talk
prédiction	prediction
rire	laugh
sans	without
soucier	worry about
baisser	lower
savoir	know
entendue	heard
car	because
dissimulé	concealed
l'avenir	the future
art	art
particulièrement	particularly
raffiné	refined
poursuivit	continued
m'attends	expect
distinguiez	stand out
soit	either
plongerez	dive
première	first
profondeurs	depths
infinies	infinite
allons	will
détendre	relax
notre	our
perception	perception
consciente	conscious
nos	our
externes	external
pris	taken
fou	crazy
dut	otc
s'enfoncer	sink
poing	fist
bouche	mouth
entendu	heard
permettrons	allow
ainsi	as well
troisième	third
Œil	Eye
conscience	consciousness
supérieure	upper
s'ouvrir	open
chance	chance
certains	some
d'entre	of
verront	see
leçon	lesson
commença	started
sentait	felt
ridicule	ridiculous
contempler	contemplate
fixement	staring
beau	beautiful
vider	empty
l'esprit	the spirit
pouvait	could
s'empêcher	help
penser	think
cela	this
parfaitement	perfectly
stupide	stupid
fous	crazy
rires	laughter
étouffés	muffled
l'aidaient	helped
soupirs	sighs
exaspérés	exasperated
d'hermione	of hermione
avez	have
demanda-t-il	he asked
après	after
quart	quarter
d'heure	time
contemplation	contemplation
silencieuse	silent
oui	yes
trace	trace
brûlure	burn
quelqu'un	someone
dû	due
renverser	reverse
bougie	candle
perd	loses
ici	here
souffla	blew
pourrais	could
d'utile	useful
place	place
rattraper	catch up
mon	my
exemple	example
passa	spent
d'eux	of them
bruissement	rustle
d'étoffe	fabric
veut-il	does he want to
interpréter	interpret
présages	omens
dessinent	draw
ombres	shadows
murmura-t-elle	she whispered
faisant	making
cliqueter	click
bracelets	bracelets
besoin	need
d'aide	help
signification	meaning
évidente	obvious
aura	will
brouillard	fog
nuit	night
éclatèrent	burst
voyons	see
s'indigna	grew indignant
têtes	heads
tournaient	turned
semblaient	seemed to
scandalisées	scandalisées
troublez	trouble
vibrations	vibration
clairvoyance	clairvoyance
déclara	said
s'approcha	approached
observa	watched
savait	knew
allait	would
passer	pass
penchant	leaning
dont	which
reflet	reflection
dédoubla	dédoubla
immenses	huge
lunettes	glasses
bouge	moves
prêt	loan
parier	bet
possédait	had
compris	including
Éclair	Flash
s'agissait	was
bonnes	good
nouvelles	new
raison	reason
pauvre	poor
garçon	boy
souffle	breath
levant	rising
clair	clear
s'avance	if advance
approche	approach
sini	sini
suffit	just
s'exclama	exclaimed
n'allez	not going to
ressortir	out
sinistros	sinistros
chuchota	whispered
l'oreille	the ear
lancèrent	launched
également	also
regard	look
noir	black
redressa	straightened
cesser	stop
d'observer	observe
regret	regret
qu'au	that
moment	time
m'est	I
apparu	appeared
évidence	obviously
n'aviez	did
don	gift
noble	noble
avouer	confess
souviens	remember
d'avoir	to have
connu	known
élève	student
désespérément	desperately
terre	earth
eut	had
silence	silence
puis	then
soudain	suddenly
leva	rose
rangea	sided
mit	mit
sac	bag
manquant	missing
tomber	fall
chaise	chair
répéta-t-elle	repeated-t-it
laisse	leaves
m'en	me
grande	great
stupéfaction	amazement
s'avança	advanced
trappe	hatch
grandes	large
enjambées	strides
l'ouvrit	the opened
descendit	went down
fallut	took
long	long
retrouver	find
calme	quiet
détourna	away
resserra	tightened
châle	shawl
épaules	shoulders
respirant	breathable
bruyamment	loudly
oooooh	oooooh
sursauter	jump
monde	world
viens	just
souvenir	remember
aviez	had
départ	starting
n'est-ce	is this
alentours	around
pâques	easter
parmi	among
quittera	leave
prévenus	defendants
longtemps	for a long time
adressa	addressed
ému	moved
vrai	true
chérie	sweetheart
dit-elle	she said
effet	effect
miss	miss
granger	granger
quitterait	leave
parfois	sometimes
espère	hope
mal	evil
interprété	interpreted
fardeau	burden
paraissaient	seemed
bouleversées	upset
elles	they
poussèrent	pushed
chaises	chairs
espérant	hoping
présent	this
s'intéresser	if interested
déchaînée	unleashed
impressionné	impressed
jeta	threw
distingua	distinguished
précis	specific
volutes	volutes
tournoyaient	whirled
lentement	slowly
l'intérieur	inside
avait-elle	had she
allait-il	was he going to
revoir	review
approchait	approaching
nouvel	new
accident	accident
vacances	holiday
furent	were
reposantes	relaxing
année	year
n'avaient	had
autant	as much
devoirs	duties
neville	neville
londubat	londubat
proche	close
crise	crisis
nerfs	nerves
seul	only
réussi	successful
rugit	roars
seamus	seamus
finnigan	finnigan
après-midi	afternoon
sont	are
éternité	eternity
jouent	play
personne	person
plaindre	complain
qu'hermione	as hermione
débarrassée	free
davantage	more
matières	materials
étudier	study
n'importe	any
d'autre	on the other
soir	evening
généralement	generally
dernière	last
quitter	leave
lendemain	next day
matin	morning
arrivait	arrived
bibliothèque	library
cernes	dark circles
grands	great
ceux	those
lupin	lupin
point	point
fondre	melt
s'occupait	was
défense	defence
faisait	was
propres	own
plongeait	dove
d'énormes	huge
volumes	volumes
titre	title
manuel	manual
psychologie	psychology
hippogriffes	hippogriffes
ou	or
encore	yet
seigneur	lord
saigneur	tapper
essai	test
brutalité	brutality
recherches	research
l'absorbaient	the absorbed
tant	as
oubliait	forgot
d'être	to be
désagréable	unpleasant
pattenrond	pattenrond
s'organiser	organize
fonction	function
séances	sessions
d'entraînement	training
interminables	endless
discussions	discussions
tactiques	tactics
infligeait	threatened
dubois	dubois
match	match
lieu	place
premier	first
samedi	Saturday
rentrée	back to school
l'instant	the moment
cents	cents
points	points
d'avance	advance
signifiait	meant
(comme	(as
manquait	missing
répéter	repeat
dubois)	dubois)
devaient	had to
absolument	absolutely
remporter	win
marquant	marking
gagner	win
coupe	cup
rôle	role
serait	would be
déterminant	determining
victoire	victory
puisque	since
vif	bright
d'or	gold
rapportait	related
cent	cent
cinquante	fifty
donc	so
devras	will have to
lorsqu'on	when
marqué	marked
cessait	stopped
sinon	otherwise
gagnera	will win
perdra	lose
olivier	olivier
hurlait	screaming
pensaient	thought
équipe	team
n'avait	had
gagné	won
légendaire	legendary
charlie	charlie
weasley	weasley
(un	(a
frère	brother
ron)	ron)
occupait	occupied
poste	post
d'attrapeur	of monkey net
nul	no
désir	desire
l'hostilité	the hostility
entre	between
été	been
intense	intense
gardait	kept
cuisant	cooking
boue	mud
reçue	received
d'autant	all
tirer	shoot
d'affaire	business
recevoir	receive
punition	punishment
tentative	attempt
sabotage	sabotage
serdaigle	ravenclaw
surtout	especially
s'était	had
passé	past
volonté	will
farouche	fierce
l'école	the school
réunie	meeting
attendu	expected
atmosphère	atmosphere
pesante	heavy
tension	voltage
maisons	houses
comble	fills
incidents	incidents
éclataient	flashed
couloirs	corridors
retrouvèrent	found
l'hôpital	the hospital
poireaux	leeks
sortaient	out
oreilles	ears
situation	situation
pénible	painful
l'autre	the other
qu'un	a
essaye	try
croche-pied	flagrant foul
donné	given
cas	case
notamment	in particular
tenteraient	try
hors	out
d'état	state
jouer	play
assuraient	provided
mission	mission
enthousiasme	enthusiasm
devenu	now
d'arriver	to arrive
foule	crowd
bruyante	noisy
bavarde	chatterbox
l'entourait	surrounded
permanence	permanently
inquiet	worried
sienne	siena
propre	own
s'en	in
l'enfermait	the enclosed
valise	suitcase
soigneusement	carefully
verrouillée	locked
précipitait	rush
dortoir	dormitory
vérifier	check
veille	eve
activité	activity
cessa	ceased
renonça	gave up
ouvrir	open
livres	books
travailler	work
concentrer	focus
tendue	tense
régnait	reigned
vacarme	din
infernal	infernal
fred	fred
george	george
défoulaient	défoulaient
montrant	showing
bruyants	noisy
exubérants	exuberant
coin	corner
penché	leaning
maquette	model
représentant	representative
terrain	field
bouger	move
petites	small
figurines	figurines
marmonnant	mumbling
paroles	lyrics
incompréhensibles	incomprehensible
angelina	angelina
alicia	alicia
katie	katie
riaient	laughing
plaisanteries	jokes
quant	as
près	near
tenait	held
l'écart	the gap
l'impression	printing
avalé	swallowed
d'énorme	huge
cherchait	was looking for
moyens	means
sortir	out
estomac	stomach
seras	will be
pleine	full
forme	form
eût	had
l'estomac	the stomach
noué	knotted
grand	great
soulagement	relief
criant	screaming
allez	go
l'équipe	the team
lit	bed
dormit	slept
nuit-là	night
d'abord	first
rêva	dreamed
étais-tu	were you
obligés	forced
prendre	take
remplacer	replace
joueurs	players
arrivaient	arrived
chevauchant	straddling
dragons	dragons
ailés	adults
volait	flying
vitesse	speed
d'éviter	to avoid
jet	jet
flammes	flames
craché	spit
dragon	dragon
s'apercevait	notices
longue	long
chute	fall
réveilla	woke up
sursaut	startle
quelques	a few
instants	moments
réaliser	make
n'aurait	would
droit	right
voler	fly
soif	thirst
bruit	noise
alla	alla
verser	pour
d'eau	water
cruche	jug
argent	money
fenêtre	window
parc	park
désert	desert
silencieux	silent
n'y	there
moindre	less
vent	wind
agiter	shake
cime	crown
arbres	trees
forêt	forest
interdite	prohibited
saule	willow
cogneur	slugger
immobile	still
paraissait	seemed
inoffensif	harmless
apparemment	apparently
idéal	ideal
reposa	rested
gobelet	cup
s'apprêtait	was about
aperçut	saw
attira	drew
attention	attention
animal	animal
rôdait	was prowling
pelouse	lawn
lune	moon
baignait	bathed
argentée	silver
précipita	rushed
chevet	bedside
nez	nose
précipitamment	hurriedly
juste	just
au-dehors	outside
chercha	sought
l'animal	the animal
repérer	identify
lisière	edge
chat	cat
s'agrippa	if agrippa
rebord	rim
venait	came
reconnaître	recognize
queue	tail
touffue	bushy
avait-il	had he
plissa	wrinkled
collé	stuck
vitre	glass
s'être	will be
arrêté	stopped
apparut	appeared
chien	dog
poil	hair
hirsute	shaggy
feutrés	felted
trottinait	trottinait
l'observa	the observed
attentivement	carefully
signifier	mean
voyait	saw
pouvait-il	could he
s'agir	be
présage	omen
mort	death
uniquement	only
destiné	for
réveille-toi	wake up
hei	hei
pâteuse	pasty
prend	takes
là-bas	there
regarde	look at
grimpa	climbed
plongeante	bird's eye
immédiats	immediate
n'étaient	there were
étaient-ils	were they
passés	past
ronflement	snoring
sonore	sound
indiqua	said
rendormi	back to sleep
entrèrent	went
accueillis	welcome
acclamations	cheers
large	wide
voyant	light
poufsouffle	hufflepuff
applaudissaient	clapping
revanche	contrast
sifflèrent	sifflèrent
passage	passage
remarqua	noticed
pâle	pale
d'habitude	usually
d'encourager	to encourage
manger	eat
lui-même	himself
touchait	touched
pressa	pressed
aient	have
afin	in order
d'aller	go
compte	account
conditions	conditions
météorologiques	weather
applaudissements	applause
retentirent	rang
bonne	good
cria	cried
cho	cho
chang	chang
sentit	felt
rougir	blush
bon	good
pratiquement	virtually
soleil	sun
fort	fort
pourrait	could
provoquer	cause
problèmes	problems
visibilité	visibility
faites	do
sol	soil
plutôt	rather
dur	hard
meilleur	best
élan	momentum
décollage	take-off
suivi	follow-up
arpenta	surveyed
regards	looks
portes	doors
s'ouvrirent	opened
sortirent	went out
masse	mass
vestiaires	locker rooms
sèchement	curtly
prononça	spoke
revêtaient	were
écarlates	scarlet
mangé	ate
remuant	stirring
annonça	announced
allons-y	let's go
déclencha	triggered
véritable	true
tempête	storm
quarts	quarters
arboraient	wore
rosettes	rosettes
agitaient	flapping
drapeaux	flags
couleur	color
ornés	decorated
lion	lion
lions	lions
lisait-on	read-on
banderoles	banners
buts	goals
habillés	dressed
vert	green
serpent	snake
argenté	silver
scintillait	sparkled
rogue	rogue
rang	rank
vêtu	dressed
souriait	smiling
voici	here
s'écria	cried
lee	lee
jordan	jordan
assurait	ensured
commentaire	comment
l'accoutumée	the usual
potter	potter
bell	bell
johnson	johnson
spinnet	spinnet
reconnue	recognized
meilleure	best
ait	has
eue	had
nombre	number
d'années	years
accueilli	hosted
huées	boos
supporters	supporters
menée	conducted
capitaine	captain
flint	flint
effectué	made
changements	changes
semble	seems
privilégié	preferred
taille	size
rapport	report
l'intelligence	the intelligence
gradins	bleachers
cependant	however
pensa	thought
tort	wrong
loin	far
joueur	player
colosses	giants
capitaines	captains
serrez	tighten
madame	mrs.
bibine	booze
s'approchèrent	came
l'un	one
serrèrent	shook
chacun	each
essayait	tried
briser	break
phalanges	phalanges
enfourchez	hop on
balais	brushes
sifflet	whistle
noyé	drowned
cris	cree
saluèrent	greeted
l'envolée	soaring
quatorze	fourteen
s'engouffrer	rush
plaisir	fun
éprouvait	felt
dissipa	cleared
trac	trac
vit	lives
suivait	followed
accéléra	accelerated
brutalement	brutally
quête	quest
l'attaque	the attack
possession	possession
souafle	souafle
descend	down
bravo	bravo
argh	argh
intercepté	intercepted
warrington	warrington
vlan	vlan
dévie	deviates
cognard	cognard
lâche	loose
récupéré	retrieved
vas-y	vas-y
marque	brand
dix	ten
À	To
zÉro	zero
faveur	for
signe	sign
enthousiastes	enthusiastic
aÏe	ouch
faillit	almost
jetée	pier
bas	the bottom
balai	broom
marcus	marcus
heurter	face
plein	full
fouet	whip
désolé	sorry
montaient	rose
l'ai	I
donna	donna
batte	bat
l'arrière	the rear
crâne	skull
s'écrasa	crashed
manche	sleeve
saigner	bleed
vint	came
placer	place
penalty	penalty
attaque	attack
injustifiée	unjustified
envers	to
poursuiveurs	poursuiveurs
délibéré	deliberate
arrêtez	stop
tira	drew
hurla	screamed
abattu	shot
stade	stage
marquÉ	marked
virage	turn
serré	tight
saignait	bleeding
mâchoires	jaws
serrées	tight
défendait	defended
excellent	excellent
gardien	guardian
commenta	commented
attendait	waiting
marquer	mark
incroyable	amazing
rÉussi	successful
bloquer	block
repartit	left
recherche	search
d'écouter	to listen
vital	vital
tienne	yours
distance	distance
obtienne	to obtain
avance	advance
file	file
exprÈs	express
montague	montague
poursuiveur	poursuiveur
coupé	cut
trajectoire	path
s'emparer	grab
attrapé	caught
tonneau	barrel
parvenant	managing
d'extrême	extreme
justesse	accuracy
rester	stay
hurlant	screaming
minute	minute
trente	thirty
sales	sales
tricheurs	cheats
partial	partial
commentaires	comments
dis	say
choses	things
telles	such
qu'elles	they
électrisé	electrified
d'apercevoir	see
l'attraper	the catch
feignant	pretending
brusque	sudden
concentration	concentration
vira	vira
fonça	rushed
stratagème	ploy
réussit	successful
poursuite	further
convaincu	convinced
swooooooshhhhhhh	swooooooshhhhhhh
siffler	whistle
lancé	launched
derrick	derrick
gigantesque	gigantic
batteur	drummer
second	second
frôla	nearly
coude	elbow
bole	bole
s'approchait	approaching
foncer	create
battes	bats
levées	lifted
dernier	last
monta	went up
chandelle	candle
s'écrasaient	crash
craquement	crunch
sinistre	disaster
ha	ha
batteurs	drummers
zigzaguer	weaving in and out of
tenant	taking into
gars	guys
faudra	will
s'empare	grabs
suivie	followed
mets-lui	put him
simple	simple
plaisanterie	joke
aïe	ouch
repris	taken
fonce	dark
bloque	blocks
marqua	marked
but	purpose
explosion	explosion
poussa	pushed
tels	such
jurons	swearing
mcgonagall	mcgonagall
essaya	tried
arracher	snatch
mains	hands
porte-voix	voice
reproduira	reproduce
mène	leads
train	train
devenir	become
déloyal	foul
joué	played
rage	rage
vite	fast
l'avance	advance
reculaient	stop
moyen	average
frappa	hit
assurant	ensuring
prise	outlet
figure	figure
représailles	retaliation
accorda	granted
bond	bond
spectaculaire	spectacular
parvint	managed
score	score
quarante	forty
suivre	follow
restait	remained
altitude	altitude
scrutant	peering
dès	as soon
l'escortèrent	the escorted
auraient	would
voulu	wanted
venger	revenge
d'elle	it
profitèrent	took advantage of the situation
l'absence	the absence
lancer	launch
cognards	cognards
reçut	received
ventre	belly
fit	fit
airs	air
cramponnant	attached
respiration	breathing
coupée	cut
furieuse	furious
n'attaque	do not attack
trouve	find
zone	area
tir	shooting
hurla-t-elle	screamed she
l'adresse	the address
soixante	sixty
envoya	sent
sauter	jump
empara	seized
soixante-dix	seventy
hurlaient	screaming
casser	break
attrapait	caught
gagnaient	earned
braqués	turned
au-	at-
dessus	top
étincelait	sparkled
mètres	meters
au-dessus	above
puissante	powerful
accélération	acceleration
sifflait	whistled
tendit	handed
l'Éclair	the Flash
ralentit	slows down
horrifié	horrified
jeté	cast
saisi	seized
l'extrémité	the end
tirait	drew
volontiers	happy
frappé	hit
portée	scope
haletant	panting
cramponnait	hanging
brillant	brilliant
narquoise	mocking
obtenu	obtained
voulait	wanted
n'ai	haven
telle	such
espÈce	species
tricheur	cheater
mégaphone	megaphone
d'abominable	abominable
s'offusqua	was shocked
terme	term
d'employer	to use
occupée	occupied
brandir	brandish
chapeau	hat
tombé	fallen
rata	rata
mètre	meter
perdait	lost
ravis	happy
mauvais	bad
sentaient	felt
stimulés	stimulated
grogna	" 
genoux	knees
cessaient	stopped
laisser	let
s'approcher	approach
dégage	releases
agacé	annoyed
barrait	gone
chemin	path
d'oeil	eye
précipitaient	rushing
route	road
changea	changed
cap	cape
pencha	bent
allongé	lying
fonçant	darkening
boulet	boulet
canon	canon
aaaaaaarrrg	aaaaaaarrrg
dispersèrent	scattered
volée	fly
moineaux	sparrows
voie	way
libre	free
quatre-vingts	eighty
failli	bankrupt
s'écraser	crashing
s'arrêter	stop
demi-tour	half-round
fila	fila
milieu	middle
cœur	heart
triomphant	triumphant
fonçait	hurtled
piqué	stung
minuscule	tiny
doré	golden
libéra	freed
puissance	power
kilomètres	kilometres
murmurait	whispered
gagnait	won
coucha	lay down
envoyait	sent
hauteur	height
lâchant	dropping
repoussa	pushed
bras	arm
tendu	tense
ouaaaaaaiiiiiis	ouaaaaaaiiiiiis
remonta	came up
tonnerre	thunder
d'acclamations	to cheers
explosa	exploded
s'éleva	rose
spectateurs	spectators
tinter	tinkle
étrangement	strangely
serrée	tight
balle	ball
battait	beat
vainement	in vain
ailes	wings
doigts	fingers
ruisselant	dripping
sanglota	sanglota
épaule	shoulder
secousses	shaking
venaient	came
rejoindre	join
entendit	heard
d'angelina	angelina
d'alicia	alicia
criaient	screaming
enchevêtrés	tangled
étreintes	hugs
laissèrent	left
descendre	down
haleine	breath
vagues	wave
successives	successive
vêtus	dressed
submergèrent	submergèrent
barrières	barriers
envahirent	invaded
état	state
corps	body
pressaient	pressed
sien	his
grandissant	growing
hissés	hoisted
projeté	projected
clarté	clarity
vêtements	clothing
parsemés	dotted
battus	beaten
raconterai	tell
oubliant	forgetting
dignité	dignity
percy	percy
sautait	jumped
dément	insane
pleurait	crying
chaudes	hot
drapeau	flag
frayaient	hailed
coups	shots
coudes	elbows
incapables	unable
prononcer	pronounce
contentèrent	content
adresser	contact
rayonnant	radiant
emporté	away
dumbledore	dumbledore
tendait	tended
seulement	only
détraqueur	détraqueur
apparaître	appear
cet	this
produit	product
magnifique	beautiful
patronus	patronus
