6	6
coups	shots
de	of
griffes	claws
et	and
feuilles	leaves
thÉ	tea
le	the
lendemain	next day
matin	morning
lorsque	when
harry	harry
ron	ron
hermione	hermione
redescendirent	climbed back down
dans	in
la	the
grande	great
salle	room
pour	for
petit	small
déjeuner	breakfast
ils	they
virent	saw
drago	drago
malefoy	malfoy
occupé	busy
à	to
raconter	tell
une	a
histoire	history
apparemment	apparently
désopilante	hilarious
tout	all
un	a
groupe	group
d'élèves	students
serpentard	slytherin
quand	when
passèrent	passed
devant	before
lui	him
il	it
fit	fit
semblant	pretend
s'évanouir	vanish
avec	with
grands	great
gestes	gestures
ridicules	ridiculous
monde	world
éclata	broke out
d'un	a
rire	laugh
tonitruant	thundering
ne	do
fais	do
pas	not
attention	attention
dit	said
qui	that
se	is
trouvait	was
juste	just
derrière	behind
t'en	you
occupe	deals
ça	it
n'en	do
vaut	worth
peine	penalty
hé	hey
potter	potter
cria	cried
d'une	a
petite	small
voix	voice
aiguë	acute
pansy	pansy
parkinson	parkinson's
élève	student
tête	head
pékinois	pekingese
les	the
détraqueurs	détraqueurs
arrivent	arrive
ooooooooh	ooooooooh
mon	my
dieu	god
je	I
défaille	fails
a	has
table	table
des	of
gryffondor	gryffindor
laissa	let
tomber	fall
sur	on
chaise	chair
côté	side
george	george
weasley	weasley
emplois	jobs
du	the
temps	time
troisième	third
année	year
en	in
faisant	making
passer	pass
qu'est-ce	what is this
t'arrive	you can
s'assit	sat
l'autre	the other
lança	launched
regard	look
furieux	furious
leva	rose
yeux	eyes
vit	lives
faisait	was
nouveau	new
terreur	terror
ce	this
crétin	moron
dit-il	he said
calme	quiet
était	was
beaucoup	a lot
moins	less
fier	proud
hier	yesterday
soir	evening
sont	are
venus	come
fouiller	search
notre	our
compartiment	compartment
tu	you
te	te
souviens	remember
fred	fred
failli	bankrupt
faire	do
pipi	pee
sa	its
culotte	panties
jetant	throwing
mépris	contempt
n'étais	there was
très	very
l'aise	comfortable
non	not
plus	more
vraiment	really
horribles	horrible
on	it
dirait	looks like
qu'ils	they
gèlent	freeze
entrailles	bowels
trouves	find
mais	but
toi	you
t'es	you're
évanoui	fainted
demanda	asked
basse	low
laisse	leaves
essayant	trying
réconforter	comfort
jour	day
papa	dad
été	been
obligé	forced
d'aller	go
azkaban	azkaban
nous	we
raconté	told
que	that
c'était	it was
l'endroit	the place
effrayant	scary
qu'il	it
ait	has
jamais	never
vu	seen
tremblait	shaking
encore	yet
est	is
revenu	income
ces	these
ont	have
chic	chic
désespérer	despair
plupart	most
prisonniers	prisoners
deviennent	become
fous	crazy
là-bas	there
verra	see
bien	well
si	if
sera	will be
toujours	always
aussi	also
joyeux	happy
fin	end
prochain	next
match	match
quidditch	quidditch
contre	against
première	first
rencontre	meeting
saison	season
fois	time
s'étaient	had
trouvés	found
face	in the face of
lors	when
avait	had
largement	widely
perdu	lost
peu	little
consolé	comforted
remplit	fills
son	its
assiette	plate
examinait	examined
attentivement	carefully
emploi	employment
ah	ah
nouvelles	new
matières	materials
aujourd'hui	today
dit-elle	she said
ravie	happy
regardant	looking at
par-dessus	above
épaule	shoulder
complètement	completely
trompés	deceived
ton	your
regarde	look at
t'ont	you have
collé	stuck
dizaine	ten
cours	during
par	by
n'auras	there will
m'arrangerai	I will try
j'ai	I
mis	put
au	the
point	point
professeur	professor
mcgonagall	mcgonagall
impossible	impossible
répondit	replied
grand	great
éclat	glow
as	as
neuf	nine
heures	hours
divination	divination
dessous	below
étude	study
moldus	muggle
incrédule	incredulous
pencha	bent
l'emploi	employment
là	there
arithmancie	arithmancie
sais	know
es	es
brillante	brilliant
personne	person
peut	can
être	be
brillant	brilliant
trouver	find
trois	three
classes	classes
différentes	different
sois	am
stupide	stupid
répliqua	replied
sèchement	curtly
sûr	course
vais	'll
suivre	follow
alor	alor
passe-moi	pass me
marmelade	marmalade
chargé	loaded
agacée	nettled
t'ai	you've
même	even
instant	now
hagrid	hagrid
entra	entered
portait	wore
long	long
manteau	coat
peau	skin
taupe	taupe
tenait	held
énorme	huge
main	hand
cadavre	corpse
putois	polecat
balançait	rocking
machinalement	going through the motions
Ça	It
va	will
demanda-t-il	he asked
s'arrêtant	stopping
leur	their
vous	you
allez	go
assister	attend
premier	first
suite	suite
après	after
me	me
suis	am
levé	survey
cinq	five
préparer	prepare
j'espère	I hope
passera	will
moi	me
j'avais	I had
pu	could
douter	doubt
eut	had
large	wide
sourire	smile
poursuivit	continued
chemin	path
vers	to
enseignants	teachers
balançant	swinging
mort	death
demande	request
préparé	prepared
inquiet	worried
élèves	students
commencèrent	started
quitter	leave
rendre	make
vérifia	verified
ferait	would
mieux	better
d'y	there
aller	go
passe	pass
haut	top
tour	tour
nord	north
faut	must
dix	ten
minutes	minutes
dépêchèrent	dispatched
terminer	finish
puis	then
sortirent	went out
lorsqu'ils	when they
éclats	shards
suivirent	followed
jusqu'au	until the
pied	foot
l'escalier	the stairs
marbre	marble
fallut	took
longtemps	for a long time
parvenir	send
malgré	despite
deux	two
années	years
passées	past
poudlard	hogwarts
connaissaient	knew
certaines	some
parties	parties
château	castle
rendaient	made
cette	this
doit	must
y	there
avoir	have
raccourci	shortcut
haleta	gasped
tandis	while
grimpaient	climbed
septième	seventh
escalier	staircase
arrivèrent	arrived
couloir	hallway
inconnu	unknown
où	where
n'y	there
rien	nothing
d'autre	on the other
qu'un	a
tableau	table
représentant	representative
vaste	wide
étendue	scope
d'herbe	grass
crois	believe
scrutant	peering
vide	empty
prolongeait	extended
droite	right
m'étonnerait	I doubt
c'est	it is
direction	management
sud	south
voit	see
bout	end
lac	lake
fenêtre	window
regardait	watched
accroché	hung
mur	wall
pierre	stone
gros	wholesale
poney	pony
gris	grey
pommelé	dapple
venait	came
d'apparaître	to appear
pré	pre
s'était	had
brouter	graze
l'herbe	the grass
air	air
nonchalant	nonchalant
l'habitude	the usual
voir	see
sujets	topics
tableaux	tables
cadre	framework
visite	visit
uns	each
aux	the
autres	other
plaisir	fun
d'assister	to attend
allées	aisles
venues	come
tard	later
chevalier	knight
trapu	stout
vêtu	dressed
armure	armor
apparut	appeared
bruit	noise
ferraille	scrap
juger	judge
traces	traces
ses	its
genouillères	knee pads
métal	metal
s'écria-t-il	cried it
voyant	light
manants	churls
s'aventurent	venture
mes	my
terres	land
serait-on	would we be
venu	come
s'esbaudir	if esbaudir
ma	my
chute	fall
garde	guard
marauds	marauds
stupéfaits	stunned
tirer	shoot
épée	sword
brandir	brandish
férocement	fiercely
sautillant	hopping
rageur	furious
l'épée	the sword
trop	too
longue	long
moulinet	reel
vigoureux	vigorous
perdre	lose
l'équilibre	the balance
tomba	fell
terre	earth
êtes	are
fait	fact
mal	evil
s'inquiéta	if worry
s'approchant	approaching
arrière	rear
maroufle	maroufle
pendard	hangdog
reprit	took
voulut	wanted
s'appuyer	support
dessus	top
relever	meet
lame	blade
s'enfonça	sank
profondément	deeply
sol	soil
qu'en	in
dépit	despite
tous	all
efforts	efforts
parvint	managed
récupérer	recover
finit	ends
laisser	let
retomber	fall
souleva	raised
visière	visor
s'éponger	sponging
front	front
Écoutez	Listen
profitant	taking advantage
répit	respite
cherchons	seek
pourriez-vous	could you
indiquer	indicate
chemi	chemi
queste	queste
foy	foy
fureur	fury
sembla	seemed
aussitôt	as soon
releva	rose
cliquetis	rattling
d'armure	armor
suivez-moi	follow me
amis	friends
obtiendrons	get
voulons	want to
ou	or
périrons	perish
bravement	bravely
bataille	battle
refit	refit
vaine	in vain
tentative	attempt
arracher	snatch
essaya	tried
sans	without
succès	success
d'enfourcher	riding
s'exclama	exclaimed
allons	will
puisqu'il	since it
ainsi	as well
vaillants	valiant
seigneurs	lords
noble	noble
dame	lady
sus	sus
donc	so
vacarme	din
précipita	rushed
gauche	left
disparut	disappeared
guidant	guiding
voyaient	saw
réapparaître	reappear
l'un	one
accrochés	hung
cœurs	hearts
pire	worst
venir	come
s'écria	cried
alors	then
surgir	arise
colimaçon	spiral
irruption	burst
représentait	represented
dames	ladies
vêtues	dressed
robes	dresses
crinoline	crinoline
provoquant	causing
passage	passage
exclamations	exclamations
effarouchées	maids
respiration	breathing
haletante	panting
escaladèrent	scaled
jusqu'à	up to
vertige	vertigo
marches	steps
étroites	narrow
montaient	rose
spirale	spiral
enfin	finally
au-dessus	above
tète	sucks
indiquèrent	indicated
étaient	were
arrivés	arrived
destination	destination
adieu	farewell
montrant	showing
moines	monks
l'air	the air
sinistre	disaster
compagnons	companions
d'armes	weapons
avez	have
besoin	need
cœur	heart
bras	arm
faiblesse	weakness
appelez	call
rescousse	rescue
catogan	catogan
appellera	call
marmonna	muttered
maboul	crazy
ajouta-t-il	he added
disparu	gone
montèrent	went up
dernières	last
minuscule	tiny
palier	bearing
classe	class
déjà	already
rassemblés	gathered
aucune	no
porte	door
autour	around
d'eux	of them
donna	donna
coup	blow
coude	elbow
plafond	ceiling
trappe	hatch
circulaire	circular
aménagée	fitted
plaque	plate
cuivre	copper
gravée	engraved
indiquait	indicated
sibylle	sibylle
trelawney	trelawney
comment	how
monter	mount
là-haut	up there
comme	as
répondre	reply
question	question
s'ouvrit	opened
brusquement	suddenly
échelle	scale
argentée	silver
descendit	went down
pieds	feet
tut	tut
monta	went up
l'échelle	the scale
émergea	emerged
étrange	strange
eût	had
vue	view
n'avait	had
plutôt	rather
l'impression	printing
vieux	old
grenier	attic
aménagé	arranged
salon	living room
thé	tea
l'ancienne	the old
vingtaine	twenty
petites	small
tables	tables
circulaires	circular
entourées	surrounded
fauteuils	chairs
recouverts	covered
chintz	chintz
petits	small
poufs	saddles
rebondis	chubby
occupaient	occupied
l'espace	the space
faible	low
lumière	light
rouge	red
éclairait	lit
pièce	room
rideaux	curtains
fenêtres	windows
tirés	from
foulards	scarves
rouges	red
enveloppaient	wrapped
lampes	lamps
régnait	reigned
chaleur	heat
étouffante	stifling
bouilloire	kettle
chauffée	heated
flammes	flames
cheminée	fireplace
encombré	crowded
d'objets	objects
divers	various
répandait	spread
capiteux	heady
parfum	perfume
donnait	gave
presque	almost
nausée	nausea
étagères	shelves
recouvraient	covered
murs	walls
encombrées	crowded
plumes	feathers
poussiéreuses	dusty
bouts	tips
chandelle	candle
jeux	games
cartes	cards
usées	waste
d'innombrables	countless
boules	balls
cristal	crystal
choix	choice
tasses	cups
bientôt	soon
rassemblèrent	together
chuchotant	whispering
est-elle	is it
douce	soft
voilée	veiled
s'éleva	rose
pénombre	penumbra
bienvenue	welcome
heureuse	happy
physique	physical
d'abord	first
insecte	insect
luisant	shiny
lueur	glow
elle	it
mince	thin
agrandis	enlarged
grosses	large
lunettes	glasses
enveloppée	wrapped
châle	shawl
vaporeux	wispy
orné	adorned
paillettes	glitter
quantité	quantity
impressionnante	impressive
chaînes	channels
perles	beads
entouraient	surrounded
cou	neck
décharné	gaunt
mains	hands
débordaient	outside
bagues	rings
bracelets	bracelets
asseyez-vous	sit
entants	entants
s'installèrent	settled
maladroitement	awkwardly
s'enfoncèrent	went
s'assirent	sat
elle-même	itself
pris	taken
place	place
fauteuil	chair
auprès	with
feu	fire
m'ayez	I have
car	because
descends	go down
rarement	rarely
l'agitation	the hustle and bustle
règne	reign
trouble	disorder
Œil	Eye
ajusta	adjusted
délicatement	gently
épaules	shoulders
choisi	chosen
d'étudier	to study
difficile	difficult
arts	arts
magiques	magic
dois	do
avertir	warn
dès	as soon
début	beginning
n'avez	do
don	gift
double	double
chance	chance
puisse	can
enseigner	teach
quoi	what
soit	either
livres	books
permettent	allow
loin	far
domaine	domain
jetèrent	cast
d'oeil	eye
amusé	amused
semblait	seemed
effarée	aghast
d'apprendre	to learn
l'étude	the study
matière	material
pouvait	could
recours	use
nombreux	many
sorciers	wizards
sorcières	witches
ailleurs	elsewhere
doués	gifted
provoquer	cause
explosions	explosions
répandre	spread
odeurs	smells
bizarres	weird
disparaître	disappear
soudainement	suddenly
révèlent	reveal
incapables	unable
pénétrer	enter
voiles	sails
mystérieux	mysterious
l'avenir	the future
brillants	brilliant
fixant	fixing
visages	faces
anxieux	anxiety
n'est	there is
accordé	granted
qu'à	as
nombre	number
garçon	boy
neville	neville
faillit	almost
pouf	pouf
est-ce	is this
votre	your
grand-mère	grand-mother
oui	yes
tremblante	trembling
j'étais	I was
serais	would be
sûre	safe
dont	which
boucles	loops
d'oreilles	earrings
émeraude	emerald
étincelaient	sparkled
parut	appeared
verrons	see
méthodes	methods
base	base
paisible	peaceful
consacrerons	devote
trimestre	quarter
lecture	reading
suivant	following
étudierons	study
lignes	lines
chérie	sweetheart
ajouta-t-elle	"she added,
tournant	turning
soudain	suddenly
parvati	parvati
patil	patil
faudra	will
méfier	beware
homme	man
cheveux	hair
roux	roux
étonné	surprised
assis	sitting
éloigna	away
viendrons	come
avons	have
fini	finished
signes	signs
malheureusement	unfortunately
seront	will be
interrompues	interrupted
février	February
cause	cause
épidémie	epidemic
grippe	flu
deviendrai	become
moi-même	myself
aphone	voiceless
alentours	around
pâques	easter
quelqu'un	someone
parmi	among
silence	silence
tendu	tense
suivit	followed
affirmation	affirmation
prêter	pay
voudrais	would like to
demander	ask
lavande	lavender
brown	brown
recroquevilla	cringed
théières	teapots
argent	money
soulagée	relieved
prit	took
théière	teapot
étagère	shelf
posa	posa
merci	thank you
signale	reports
redoutez	dread
tant	as
produira	will
vendredi	Friday
16	16
octobre	October
mit	mit
trembler	shake
maintenant	now
veux	want to
fassiez	do
équipe	team
prenez	take
tasse	cup
l'étagère	the shelf
venez	come
l'apporter	bring
remplirai	fill
ensuite	then
assiérez	sit
boirez	drink
reste	rest
fond	background
ferez	will
tourner	turn
retournerez	return
au-	at-
soucoupe	saucer
attendrez	wait
dernière	last
goutte	drop
tombée	fallen
donnerez	give
partenaire	partner
lise	lise
interpréterez	'll be doing
formes	forms
obtenues	obtained
référant	referring
pages	pages
5	5
livre	book
lever	sunrise
voile	sailing
futur	future
passerai	pass
aider	help
prenant	taking
aurez	will
cassé	broken
j'aimerais	I would like to
preniez	take
bleue	blue
tiens	want
rosés	rosé
effet	effect
s'était-il	was he
approché	approached
porcelaine	porcelain
brisée	broken
pelle	shovel
balayette	dustpan
ennuie	bored
eurent	had
remplies	true
revinrent	returned
s'efforcèrent	the aim
boire	drink
brûlant	burning
vite	fast
possible	possible
firent	did
l'avait	had
indiqué	indicated
retournèrent	returned
tombent	fall
gouttes	drops
échangèrent	exchanged
bon	good
ouvraient	opened
vois	see
mienne	mine
truc	trick
marron	brown
mou	soft
fumée	smoke
odorante	fragrant
s'élevait	was
brouillait	blurred
l'esprit	the spirit
sommeil	sleep
ouvrez	open
esprit	spirit
chéris	cherish
laissez	let
vos	your
au-delà	beyond
apparences	appearances
réveiller	wake up
vague	wave
forme	form
croix	cross
consultant	consultant
veut	wants to
dire	say
vas	vas
connaître	know
épreuves	tests
souffrances	suffering
désolé	sorry
autre	other
chose	thing
pourrait	could
soleil	sun
attends	wait
bonheur	happiness
souffrir	suffer
seras	will be
heureux	happy
aurais	would have
intérêt	interest
vérifier	check
avis	notice
réprimèrent	repressed
sous	under
perçant	piercing
regarda	looked at
plissé	pleated
l'effort	the effort
espèce	species
boule	ball
ressemble	looks like
chapeau	hat
melon	melon
annonça-t-il	he announced
peut-être	maybe
travailler	work
ministère	department
magie	magic
tourna	turned
sens	meaning
côté-là	side
gland	acorn
parcourut	went through
somme	sum
d'argent	money
inattendue	unexpected
l'or	gold
arrive	happens
lui-même	himself
pouvoir	power
m'en	me
animal	animal
voilà	this is
hippopotame	hippopotamus
mouton	sheep
s'approcha	approached
laissait	left
échapper	escape
montrez-moi	show me
réprobateur	réprobateur
arrachant	snatching
attendit	waited
observait	watched
inverse	reverse
aiguilles	needles
montre	watch
faucon	falcon
pauvre	poor
chéri	darling
ennemi	enemy
mortel	mortal
sait	knows
murmure	whisper
parfaitement	perfectly
audible	audible
courant	current
l'histoire	the story
entre	between
vous-savez-qui	you-know-who
regardèrent	looked
mélange	mix
d'étonnement	astonishment
d'admiration	admiration
n'avaient	had
entendu	heard
parler	talk
manière	way
s'abstint	refrained
reporta	re-scheduled
continua	continued
doigts	fingers
massue	club
attaque	attack
bonne	good
cru	raw
timidement	timidly
danger	danger
paralysés	paralyzed
regardaient	watched
fixement	staring
haut-le-corps	top-the-body
poussa	pushed
cri	cry
casser	break
deuxième	second
fermés	closed
étincelante	sparkling
posée	asked
demandez	ask
dean	dean
thomas	thomas
levés	surveys
lentement	slowly
s'approchèrent	came
jeter	throw
ouvrant	opening
tragique	tragic
sinistros	sinistros
n'était	there was
seul	only
compris	including
haussant	raising
déconcerté	baffled
tenaient	held
bouche	mouth
geste	gesture
horrifié	horrified
choquée	shocked
n'ait	did
gigantesque	gigantic
chien	dog
fantôme	ghost
hante	haunts
cimetières	cemeteries
présages	omens
présage	omen
sentit	felt
estomac	stomach
retourner	return
couverture	coverage
librairie	library
traverse	crosses
l'obscurité	the dark
magnolia	magnolia
crescent	crescent
plaqua	wood, and overlaid
tournés	shot
sauf	except
approchée	approached
par-derrière	from behind
s'agisse	whether
neutre	neutral
contempla	stared at
hostilité	hostility
grandissante	growing
excusez-moi	excuse me
perçois	see
aura	will
semblez	seem to
preuve	proof
réceptivité	receptivity
limitée	limited
résonances	resonances
seamus	seamus
finnigan	finnigan
balança	swung
demi	half
pense	think
âne	ass
penchant	leaning
décidé	decided
mourir	die
direz	say
déclara	said
surpris	surprised
propres	own
paroles	lyrics
présent	this
n'osait	did not dare to
regarder	watch
rester	stay
mystérieuse	mysterious
pouvez	can
ranger	ranger
affaires	business
silencieux	silent
rapportèrent	reported
leurs	their
rangèrent	them
refermèrent	slid shut
sacs	bags
évitait	avoided
attendant	waiting
fortune	fortune
favorable	favourable
arriver	getting
retard	delay
prochaine	next
essayez	try
rattraper	catch up
descendirent	went down
prirent	took
devait	should
donner	give
métamorphose	metamorphosis
avaient	had
quitté	left
heure	time
mirent	started
tellement	so
faillirent	almost
projecteur	projector
braqué	put
cessaient	stopped
lancer	launch
regards	looks
furtifs	stealth
s'ils	if they
s'attendaient	expected
entendit	heard
raconta	told
animagi	animagi
(les	(the
capables	capable
transformer	transform
animaux)	animals)
lorsqu'elle	when it
métamorphosa	turned her
chat	cat
tigré	tabby
conservant	retaining
marque	brand
s'étonna	was surprised
habituelle	usual
émettant	emitting
pop	pop
semblable	similar
bouteille	bottle
champagne	champagne
qu'on	we
débouche	leads
métamorphoses	metamorphoses
déclenchent	trigger
aucun	no
applaudissement	applause
tournèrent	turned
s'est	is
passé	past
eu	had
lu	read
comprends	understand
l'interrompit	the interrupted
fronçant	frowned
sourcils	eyebrows
inutile	useless
miss	miss
granger	granger
dites-moi	tell me
anné	year
ronds	round
savoir	know
chaque	each
depuis	since
arrivée	arrival
école	school
prédit	predicted
or	gold
resté	stayed
vivant	living
commence	begins
l'année	the year
scolaire	school
décelant	detecting
n'avais	had
habitude	usual
collègues	colleagues
s'interrompit	if interrupted
chacun	each
put	put
ailes	wings
nez	nose
devenues	become
livides	livid
l'une	one
branches	branches
nébuleuses	nebulae
reprit-elle	she said
calmement	calmly
cacherai	hide
j'éprouve	I feel
certain	some
agacement	annoyance
genre	kind
pratiques	practices
voyants	lights
véritables	true
extrêmement	extremely
rares	rare
naturel	natural
paraissez	look
excellente	excellent
santé	health
regret	regret
annoncer	announce
serez	will be
dispensé	provided
devoir	duty
mourez	die
promets	promise
lueurs	light
rougeâtres	reddish
parfums	perfumes
anesthésiants	anaesthetics
n'inspiraient	not inspired
mêmes	same
angoisses	anxieties
pourtant	yet
rassuré	reassured
paraissait	seemed
murmura	whispered
mêlèrent	mixed
cohue	crush
précipitaient	rushing
souris	mouse
conseilla	advised
poussant	pushing
plat	flat
ragoût	stew
qu'a	that has
fourchette	range
mangea	ate
grave	serious
n'as	did
noir	black
n'est-ce	is this
j'en	I
ai	I
parti	party
chez	in
dursley	dursley
doute	doubt
errant	wandering
devenue	become
folle	crazy
c	c
mauvais	bad
signe	sign
oncle	uncle
bilius	bilius
vingt-quatre	twenty-four
simple	simple
coïncidence	coincidence
léger	lightweight
versant	slope
jus	juice
citrouille	pumpkin
dis	say
n'importe	any
s'indigna	grew indignant
commençait	started
mettre	put
colère	anger
terrifiés	terrified
l'explication	the explanation
docte	learned
voient	see
meurent	die
peur	fear
parce	because
assez	enough
puisque	since
n'ai	haven
rentrer	return
six	six
ouvrit	opened
tira	drew
sac	bag
d'arithmancie	of arithmancie
qu'elle	it
appuya	supported
carafe	decanter
cherchant	seeking
page	page
devinettes	guessing
s'emporta	if carried
avais	had
s'agissait	was
froidement	coldly
d'aura	aura
laquelle	which
n'es	no es
douée	gifted
t'énerve	bugging you
touché	hit
sensible	sensitive
referma	closed
telle	such
violence	violence
morceaux	pieces
carotte	carrot
viande	meat
volèrent	flew
doué	gifted
signifie	means
tas	heap
continuer	continue
l'étudier	the study
nullité	void
totale	total
rapport	report
apprend	learn
saisit	captures
s'en	in
alla	alla
partir	from
raconte	tells
s'étonna-t-il	was surprised there
n'a	did
fut	was
content	content
sortir	out
pluie	rain
veille	eve
cessé	stopped
ciel	sky
couleur	color
clair	clear
souple	flexible
humide	wet
soins	care
créatures	creatures
parlaient	spoke
marchait	walked
pelouse	lawn
descendait	down
pente	slope
cabane	hut
lisière	edge
forêt	forest
interdite	prohibited
lorsqu'il	when it
aperçut	saw
silhouettes	silhouettes
familières	familiar
précédaient	prior to
comprit	understood
allaient	would
également	also
parlait	spoke
vivacité	vivacity
crabbe	crabbe
goyle	goyle
pouffaient	pouffaient
deviner	guess
sujet	about
conversation	conversation
debout	standing
crockdur	crockdur
molosse	mastiff
attendait	waiting
impatient	looking forward
commencer	start
dépêchez-vous	hurry up
lança-t-il	"he shouted,
surprise	surprise
n'allez	not going to
ennuyer	bored
croyez-moi	believe me
pendant	during
craignit	feared
emmène	takes
suffisamment	enough
d'expériences	experiences
désagréables	unpleasant
envie	want
remettre	back
resta	remained
bordure	border
arbres	trees
retrouvèrent	found
d'enclos	enclosures
rassemblez-vous	gather
barrière	barrier
ouvrir	open
glaciale	icy
traînante	shuffling
nos	our
répéta	repeated
sortit	went out
exemplaire	copy
monstrueux	monstrous
monstres	monsters
ficelé	crafted
morceau	song
corde	rope
d'autres	other
certains	some
attachés	attached
ceinture	belt
serrés	tight
étroits	close
d'énormes	huge
pinces	pliers
réussi	successful
stupéfait	stunned
simplement	simply
caresser	caress
évidente	obvious
regardez	watch
l'exemplaire	the copy
d'hermione	of hermione
arracha	tore
papier	paper
collant	sticky
maintenait	maintained
fermé	closed
mordre	bite
passa	spent
doigt	finger
dos	back
l'ouvrage	the book
secoué	shaken
frisson	thrill
paisiblement	peacefully
oh	oh
sommes-nous	are we
bêtes	beasts
goguenard	bantering
suffisait	enough
aurait	would
dû	due
trouvais	found
drôles	funny
assurée	insured
extraordinairement	extraordinarily
quelle	what
merveilleuse	wonderful
idée	idea
acheter	buy
essayent	try
dévorer	devour
abattu	shot
voulait	wanted
surtout	especially
fil	wire
manque	lack
chercher	search
attendez-moi	wait for me
s'éloigna	walked away
bas	the bottom
forte	strong
devenu	now
père	father
raconterai	tell
détraqueur	détraqueur
ooooooooooooh	ooooooooooooh
suraiguë	shrill
pointant	pointing
l'extrémité	the end
l'enclos	the enclosure
douzaine	dozen
vues	views
trottinaient	trottinaient
elles	they
corps	body
pattes	legs
queue	tail
cheval	horse
avant	before
semblaient	seemed to
provenir	come
d'aigles	eagles
dotés	with
longs	long
becs	beaks
acier	steel
orange	orange
pourvues	with
serres	greenhouses
redoutables	formidable
quinzaine	fifteen
centimètres	centimeters
portaient	wore
d'épais	thick
colliers	necklaces
cuir	leather
longues	long
extrémités	ends
immense	huge
rugit	roars
agitant	waving
entrer	enter
reculèrent	went back
attacha	tied
hippogriffes	hippogriffes
annonça	announced
magnifiques	beautiful
comprenait	included
choc	shock
créature	creature
mi-cheval	half-horse
mi-oiseau	mid-bird
apprécier	enjoy
l'éclat	the glow
chatoyant	shimmering
plumage	plumage
transformait	transformed
pelage	coat
différente	different
gris-bleu	grey-blue
vert	green
bronze	bronze
blanc	white
rosé	rosé
marron-rouge	brown-red
d'encre	ink
frottant	rubbing
visage	face
rayonnant	radiant
voulez	want to
approcher	approach
s'avancèrent	advanced
cependant	however
prudence	caution
font	do
fierté	pride
susceptibles	likely
insultez	insult
sinon	otherwise
peut-	can-
faite	made
vie	life
n'écoutaient	listen to
désagréable	unpleasant
impression	print
cherchaient	looking
meilleur	best
moyen	average
incident	incident
attendre	wait
l'hippogriffe	the hippogriffe
fasse	do
attachée	attached
politesse	politeness
s'avancer	advance
saluer	greet
s'inclinant	bowing
s'il	if it
salue	greet
droit	right
toucher	touch
conseille	advises
filer	spinning
dégât	damage
essayer	try
toute	any
réponse	response
davantage	more
n'étaient	there were
eux	them
secouaient	shook
féroce	fierce
remuant	stirring
puissantes	powerful
d'être	to be
implorant	imploring
étouffées	stifled
murmurèrent	murmured
souviens-toi	remember
prêta	lent
enjamba	stepped over
bravo	bravo
voyons	see
buck	buck
détacha	detached
l'écart	the gap
enleva	removed
collier	necklace
retenaient	holding
souffle	breath
scène	scene
plissant	squinting
méchants	wicked
croisé	cross
essaye	try
ciller	ciller
méfient	suspicious
cligne	blink
souvent	often
picotements	tingling
s'efforça	tried
fermer	close
tourné	shot
grosse	big
pointue	sharp
fixaient	set
incline-toi	tips-you
d'exposer	to expose
nuque	neck
disait	said
inclina	bowed
brièvement	briefly
redressa	straightened
hautain	haughty
moindre	less
contrarié	upset
recule	retreats
brusquer	rush
cet	this
plia	folded
s'inclina	bowed
enchanté	enchanted
vas-y	vas-y
peux	can
caresse-lui	caress him
bec	bec
estimait	estimated
mérité	deserved
repasser	iron
s'avança	advanced
tendit	handed
caressa	stroked
plusieurs	several
reprises	times
l'animal	the animal
ferma	closed
paresseusement	lazily
prenait	took
applaudirent	cheered
rompre	break
paraissaient	seemed
terriblement	terribly
déçus	disappointed
parfait	perfect
l'idée	the idea
séduisant	seductive
habitué	used
piloter	drive
balais	brushes
facilement	easily
chevaucher	overlap
hippogriffe	hippogriffe
grimpe	climbs
plume	pen
n'aimerait	do not would like to
l'aile	the wing
hissa	hissa
savait	knew
tenir	take
portée	scope
craignait	feared
d'en	to
donnant	giving
tape	tape
l'arrière-train	the rear-train
quatre	four
mètres	meters
d'envergure	large-scale
déployèrent	went to
battre	beat
s'accrocher	hang on
celui-ci	it
s'élève	amounts
airs	air
balai	broom
sut	sut
immédiatement	immediately
préférait	preferred
immenses	huge
battaient	fighting
côtés	sides
cognaient	banged
jambes	legs
menaçant	threatening
désarçonner	dismounting
luisantes	shiny
glissaient	slide
serrer	tighten
fort	fort
regrettait	regretted
souplesse	flexibility
nimbus	nimbus
2000	2000
ballotté	tossed
montait	rose
rythme	pace
battements	beats
d'aile	wing
décrivit	described
cercle	circle
piqua	piqua
moment	time
redoutait	feared
baissa	lowered
allait	would
glisser	drag
cramponner	cling
l'instant	the moment
sourd	deaf
dépareillées	mismatched
venaient	came
poser	ask
redresser	straighten
sain	healthy
beau	beautiful
travail	work
applaudissait	applauded
bruyamment	loudly
enhardis	emboldened
pénétrèrent	penetrated
prudemment	cautiously
certaine	some
appréhension	apprehension
incliné	inclined
caressait	caressed
dédaigneux	dismissive
facile	easy
l'entende	hear
forcément	necessarily
arrivé	arrived
parie	bet
absolument	absolutely
dangereux	dangerous
s'adressant	addressing
brute	gross
repoussante	repulsive
éclair	flash
griffe	claw
fendit	split
hurlement	howl
fraction	fraction
seconde	second
s'efforçait	tried
grand-peine	great difficulty
essayait	tried
dernier	last
recroquevillé	curled up
tache	spot
sang	blood
s'élargissait	expanded
robe	dress
sorcier	sorcerer
saisis	seized
panique	panic
meurs	die
hurla	screamed
bestiole	critter
m'a	me
tué	killed
livide	livid
aidez-moi	help me
d'ici	here
courut	ran
hissait	rose
profonde	deep
entaille	notch
coulait	flowed
courir	run
bouleversé	upset
contentant	simply
marcher	walk
déchaînaient	unchained
devraient	should
renvoyer	return
sur-le-champ	on-the-field
larmes	tears
faute	fault
gonflèrent	gonflèrent
biceps	biceps
hall	hall
d'entrée	input
désert	desert
étages	floors
cesser	stop
vilipender	vilify
s'éloignèrent	wandered up to
commune	common
située	located
sous-sols	sub-soil
rejoindre	join
préoccupée	concerned
madame	mrs.
pomfresh	pomfresh
coupure	cut
soigner	treat
blessures	injuries
sérieuses	serious
l'infirmière	the nurse
dons	donations
terrible	terrible
confiance	trust
gâcher	spoil
l'heure	the time
dîner	dinner
furent	were
premiers	first
descendre	down
espérant	hoping
l'ont	have
renvoyé	returned
anxieuse	anxious
contenu	content
n'ont	have
mangeait	ate
lesquels	which
absorbés	absorbed
parié	bet
train	train
propre	own
version	version
l'incident	the incident
cas	case
ennuyés	bored
rentrée	back to school
sombre	dark
remontèrent	went
essayèrent	tried
donné	given
n'arrivait	there was
concentrer	focus
consulta	consulta
dépêche	hurry
tôt	early
prudent	careful
promener	walk
l'enceinte	the speaker
l'école	the school
parc	park
sirius	sirius
black	black
barrage	dam
sache	know
rencontrer	meet
évita	evita
d'avoir	to have
justifier	justify
présence	presence
couloirs	corridors
heure-là	time
noire	black
crépuscule	twilight
entrez	enter
grogna	" 
frappèrent	beat
chemise	shirt
bois	wood
brut	gross
posé	asked
genoux	knees
d'œil	eye
comprirent	understood
bu	bu
chope	mug
d'étain	tin
taille	size
seau	bucket
vitreux	glassy
sûrement	surely
record	record
pâteuse	pasty
accablé	overwhelmed
buvant	drinking
gorgée	sip
contenait	contained
va-t-il	will he
s'asseyaient	sat
sombrement	darkly
souffre	suffers
gémit	moans
cesse	stops
couvert	covered
bandages	bandages
joue	plays
comédie	comedy
affirma	said
capable	able
blessure	injury
repousser	push
moitié	half
os	os
compter	from
profiter	enjoy
maximum	maximum
situation	situation
conseil	council
d'administration	of directors
informé	informed
estiment	consider
j'aurais	I would have
veracrasses	veracrasses
quelque	some
entièrement	fully
gravité	gravity
témoins	witnesses
prévenus	defendants
attaquent	attack
insulte	insult
écouter	listen
dumbledore	dumbledore
inquiétez	worry
soutiendra	support
apparurent	appeared
noirs	black
coulèrent	sank
coin	corner
paupières	eyelids
craquelées	cracked
rides	wrinkles
serra	serra
étreinte	hug
vider	empty
raison	reason
approuva	approved
lâchant	dropping
s'écartèrent	if parted
chancelant	tottering
côtes	coast
s'arracha	tore itself away
rejoignit	joined
au-dehors	outside
démarche	approach
incertaine	uncertain
entendirent	heard
d'éclaboussures	splash
qu'hermione	as hermione
revenait	back
plongé	immersed
tonneau	barrel
d'eau	water
répondit-elle	she replied
rangeant	ranking
réapparut	reappeared
barbe	beard
ruisselant	dripping
secouant	shaking
mouillé	wet
gentil	nice
s'apercevoir	see
lÀ	there
rugit-il	roars-it
bond	bond
traÎner	hanging out
dehors	outside
nuit	night
ramener	bring
reprenne	resume
coucher	bedroom
vaux	vaux
