9	9
sinistre	disaster
dÉfaite	defeat
le	the
professeur	professor
dumbledore	dumbledore
renvoya	back
les	the
élèves	students
de	of
gryffondor	gryffindor
dans	in
la	the
grande	great
salle	room
où	where
ils	they
furent	were
rejoints	joined
dix	ten
minutes	minutes
plus	more
tard	later
par	by
ceux	those
poufsouffle	hufflepuff
serdaigle	ravenclaw
et	and
serpentard	slytherin
qui	that
semblaient	seemed to
complètement	completely
désorientés	disoriented
professeurs	teachers
moi-même	myself
devons	must
fouiller	search
systématiquement	systematically
château	castle
annonça	announced
tandis	while
que	that
mcgonagall	mcgonagall
flitwick	flitwick
fermaient	closed
toutes	all
portes	doors
donnaient	gave
accès	access
à	to
je	I
crains	fear
pour	for
votre	your
propre	own
sécurité	security
il	it
soit	either
nécessaire	necessary
vous	you
passiez	pass
nuit	night
ici	here
demande	request
aux	the
préfets	prefects
monter	mount
garde	guard
confie	entrust
au	the
préfet	prefect
préfète-en-chef	préfète-in-chief
soin	care
d'organiser	organize
choses	things
tout	all
incident	incident
devra	should
m'être	me be
immédiatement	immediately
signalé	reported
ajouta-t-il	he added
en	in
s'adressant	addressing
percy	percy
paraissait	seemed
gonflé	inflated
d'orgueil	pride
d'importance	of importance
demanderez	ask
l'un	one
des	of
fantômes	ghosts
me	me
transmettre	pass
un	a
message	message
cas	case
besoin	need
s'apprêtait	was about
quitter	leave
mais	but
se	is
ravisa	thought better of it
soudain	suddenly
j'oubliais	I forgot
dit-il	he said
allez	go
avoir	have
fit	fit
geste	gesture
négligent	neglect
avec	with
sa	its
baguette	wand
magique	magic
aussitôt	as soon
longues	long
tables	tables
s'envolèrent	flew
s'aligner	align
contre	against
murs	walls
autre	other
coup	blow
sol	soil
couvrit	covered
centaines	hundreds
gros	wholesale
sacs	bags
couchage	sleeping
moelleux	fluffy
d'une	a
couleur	color
violette	violet
dormez	sleep
bien	well
dit	said
refermant	closing
porte	door
derrière	behind
lui	him
grand	great
brouhaha	hubbub
s'éleva	rose
étaient	were
train	train
raconter	tell
ce	this
s'était	had
passé	past
autres	other
maisons	houses
monde	world
cria	cried
fini	finished
bavardages	chatter
extinction	extinction
feux	lights
venez	come
ron	ron
harry	harry
hermione	hermione
prirent	took
allèrent	went
s'installer	install
coin	corner
croyez	believe
black	black
est	is
toujours	always
murmura	whispered
d'un	a
air	air
anxieux	anxiety
apparemment	apparently
persuadé	persuaded
c'est	it is
une	a
chance	chance
qu'il	it
ait	has
choisi	chosen
soir	evening
manifester	show
qu'ils	they
glissaient	slide
habillés	dressed
leurs	their
c'était	it was
seule	only
soirée	evening
on	it
n'était	there was
pas	not
tour	tour
a	has
dû	due
perdre	lose
notion	concept
du	the
temps	time
force	force
d'être	to be
fuite	leak
ne	do
s'est	is
aperçu	overview
halloween	halloween
sinon	otherwise
aurait	would
débarqué	landed
fut	was
secouée	shaken
frisson	thrill
autour	around
d'eux	of them
posaient	asked
même	even
question	question
uns	each
comment	how
a-t-	a-t-
fait	fact
entrer	enter
peut-être	maybe
faculté	faculty
transplaner	transplaner
élève	student
tu	you
sais	know
apparaître	appear
airs	air
comme	as
si	if
venait	came
nulle	void
part	share
sans	without
doute	doubt
déguisé	disguised
ou	or
volé	stolen
jusqu'ici	up here
suggéra	suggested
dean	dean
thomas	thomas
est-ce	is this
suis	am
vraiment	really
personne	person
jamais	never
pris	taken
peine	penalty
lire	read
l'histoire	the story
poudlard	hogwarts
alors	then
colère	anger
probablement	probably
répondit	replied
pourquoi	why
parce	because
protégé	protected
chose	thing
simples	simple
murailles	walls
poursuivit	continued
existe	there is
nombreux	many
sortilèges	spells
empêchent	prevent
d'y	there
clandestinement	secretly
peut	can
contenter	just
endroit	place
pareil	such
j'aimerais	I would like to
savoir	know
sous	under
quel	what
déguisement	disguise
pourrait	could
berner	berner
détraqueurs	détraqueurs
gardent	keep
tous	all
l'école	the school
l'auraient	would
aussi	also
vu	seen
voler	fly
puis	then
rusard	rusard
connaît	knows
passages	passages
secrets	secrets
penses	think
sont	are
surveillés	monitored
éteint	off
lumières	lights
maintenant	now
mot	word
chandelles	candles
s'éteignirent	went out
seul	only
seules	only
sources	sources
lumière	light
venaient	came
présent	this
forme	form
argentée	silver
flottaient	floating
s'entretenant	talking
gravement	seriously
plafond	ceiling
parsemé	dotted
d'étoiles	star
l'image	the image
ciel	sky
rumeur	rumor
chuchotements	whispers
semblable	similar
murmure	whisper
vent	wind
s'ajoutait	added
donnant	giving
l'impression	printing
dormait	slept
belle	beautiful
étoile	star
son	its
brise	breeze
légère	light
chaque	each
heure	time
revenait	back
vérifier	check
était	was
calme	quiet
vers	to
trois	three
heures	hours
matin	morning
plupart	most
s'étaient	had
enfin	finally
endormis	asleep
entra	entered
vit	lives
s'avancer	advance
circulait	riding
entre	between
réprimandant	rebuking
parlaient	spoke
très	very
loin	far
firent	did
semblant	pretend
dormir	sleep
lorsqu'ils	when they
entendirent	heard
s'approcher	approach
l'avez	have
repéré	spotted
demanda	asked
non	not
encore	yet
va	will
nous	we
avons	have
situation	situation
main	hand
monsieur	mr.
directeur	director
serait	would be
inutile	useless
faire	do
sortir	out
j'ai	I
trouvé	found
gardien	guardian
temporaire	temporary
remplacer	replace
grosse	big
dame	lady
pourrez	can
ramener	bring
dès	as soon
demain	tomorrow
elle	it
cache	cache
carte	card
géographie	geography
premier	first
étage	floor
refusé	refused
laisser	let
passe	pass
l'a	the
attaquée	attacked
choquée	shocked
qu'elle	it
sera	will be
calmée	calmed down
demanderai	ask
mr	mr
restaurer	restore
entendit	heard
grincement	grinding
s'ouvrait	opened
nouveau	new
d'autres	other
bruits	noise
s'approchaient	approaching
rogue	rogue
resta	remained
parfaitement	perfectly
immobile	still
l'oreille	the ear
tendue	tense
deuxième	second
été	been
entièrement	fully
fouillé	searched
n'y	there
inspecté	inspected
sous-	sub-
sols	soil
rien	nothing
là-bas	there
d'astronomie	astronomy
pièce	room
trelawney	trelawney
volière	aviary
severus	severus
m'attendais	was expecting
traîne	trolling
parages	area
avez-vous	have you
idée	idea
façon	how
dont	which
entré	entered
souleva	raised
légèrement	slightly
tête	head
posée	asked
sur	on
bras	arm
dégager	release
oreille	ear
j'en	I
ai	I
beaucoup	a lot
elles	they
invraisemblables	unbelievable
unes	each
ouvrit	opened
yeux	eyes
voir	see
trouvaient	were
deux	two
tournait	turned
dos	back
voyait	saw
visage	face
écoutait	listened to
attention	attention
profil	profile
furieux	furious
souvenez	remember
conversation	conversation
eue	had
juste	just
avant	before
début	beginning
trimestre	quarter
remuant	stirring
lèvres	lips
s'il	if it
voulait	wanted
éviter	avoid
l'entende	hear
m'en	me
souviens	remember
quelque	some
voix	voice
ressemblait	looked like
avertissement	warning
paraît	seems
presque	almost
impossible	impossible
pu	could
pénétrer	enter
complicité	complicity
interne	internal
mes	my
inquiétudes	concerns
lorsque	when
avez	have
nommé	named
crois	believe
aidé	helped
y	there
ton	your
définitif	final
taire	shut up
faut	must
j'aille	I go
leur	their
préviendrais	préviendrais
quand	when
nos	our
recherches	research
seraient	would be
terminées	completed
n'ont	have
proposé	proposed
aider	help
oh	oh
froidement	coldly
affirmer	say
qu'aucun	no
détraqueur	détraqueur
franchira	crosses
l'enceinte	the speaker
tant	as
serai	am
peu	little
désarçonné	unseated
quitta	left
rapide	fast
silencieux	silent
instant	now
regardant	looking at
partir	from
expression	expression
profonde	deep
rancœur	the grudge
s'en	in
alla	alla
jeta	threw
regard	look
oblique	oblique
eux	them
avaient	had
ouverts	open
qu'est-ce	what is this
ça	it
veut	wants to
dire	say
jours	days
suivirent	followed
toute	any
parla	spoke
sirius	sirius
chacun	each
ayant	having
théorie	theory
hannah	hannah
abbot	abbot
prétendit	claimed
changé	changed
arbuste	shrub
parc	park
être	be
toile	canvas
déchirée	torn
avait	had
décrochée	unhooked
mur	wall
remplacée	replaced
portrait	portrait
chevalier	knight
catogan	catogan
poney	pony
gris	grey
n'enchantait	enchanted
passait	passed
moitié	half
provoquer	cause
duel	duel
l'autre	the other
inventer	invent
mots	words
ridiculement	ridiculously
compliqués	complicated
modifiait	changed
moins	less
fois	time
jour	day
fou	crazy
seamus	seamus
finnigan	finnigan
quelqu'un	someone
d'autre	on the other
aucun	no
n'a	did
accepté	accepted
reprendre	resume
poste	post
peur	fear
subir	undergo
sort	fate
suffisamment	enough
courageux	brave
porter	wear
volontaire	voluntary
cependant	however
dernier	last
soucis	worries
préoccupait	concern
davantage	more
surveillance	monitoring
constante	constant
l'objet	the object
prétexte	excuse
l'accompagner	accompany
couloirs	corridors
weasley	weasley
(que	(that
soupçonnait	suspected
d'agir	to act
ordre	order
mère)	mother)
suivait	followed
partout	everywhere
manière	way
chien	dog
allures	gait / movement
solennelles	solemn
couronner	top
convoqua	summoned
bureau	office
grave	serious
s'attendait	expected
l'entendre	hear
annoncer	announce
mort	death
servirait	would
cacher	hide
longtemps	for a long time
potter	potter
dit-elle	she said
lugubre	gloomy
certainement	certainly
choc	shock
sachiez	know
cherche	looking
tuer	kill
courant	current
acheva	completed
las	las
entendu	heard
père	father
mère	mother
travaille	works
ministère	department
magie	magic
parut	appeared
stupéfaite	stunned
fixa	fixa
pendant	during
bon	good
moment	time
parole	word
comprendrez	understand
n'est	there is
souhaitable	desirable
participiez	participate
séances	sessions
d'entraînement	training
quidditch	quidditch
terrain	field
découvert	discovered
compagnie	company
vos	your
seuls	only
coéquipiers	teammates
êtes	are
exposé	presentation
doit	must
jouer	play
notre	our
match	match
samedi	Saturday
prochain	next
s'insurgea	rose
absolument	absolutely
m'entraîne	leads me
l'observa	the observed
intense	intense
savait	knew
attachait	attached
importance	importance
l'avenir	the future
l'équipe	the team
après	after
suggéré	suggested
qu'on	we
l'engage	the committed
attrapeur	monkey net
attendit	waited
retenant	retaining
souffle	breath
leva	rose
regarda	looked at
fenêtre	window
apercevait	caught sight of
travers	through
pluie	rain
savez	know
équipe	team
remporte	wins
coupe	cup
serais	would be
tranquille	quiet
là	there
veiller	ensure
vais	'll
demander	ask
madame	mrs.
bibine	booze
d'assister	to attend
empirait	and getting worse
mesure	measurement
rapprochait	close
date	date
n'en	do
continuait	continued
s'entraîner	train
ardeur	ardor
l'œil	the eye
vigilant	vigilant
lors	when
dernière	last
séance	session
olivier	olivier
dubois	dubois
mauvaise	bad
nouvelle	new
n'allons	not going to
flint	flint
venu	come
rencontrer	meet
place	place
m'a	me
donné	given
excuse	excuse
blessure	injury
grinçant	squeaky
dents	teeth
évident	obvious
raison	reason
veulent	want to
pensent	think
auraient	would
chances	chances
gagner	win
journée	day
soufflé	blown
violence	violence
pleuvait	was raining
cesse	stops
tonnerre	thunder
retentir	sound
malefoy	malfoy
s'exclama	exclaimed
joue	plays
comédie	comedy
prouver	prove
amer	bitter
sommes	are
entraînés	trained
croyant	believing
allions	were going to
affronter	face
devrons	will have to
ont	have
style	style
différent	different
capitaine	captain
s'appelle	is called
cedric	cedric
diggory	diggory
angelina	angelina
alicia	alicia
katie	katie
mirent	started
glousser	squealing
visiblement	obviously
choqué	shocked
frivolité	frivolity
type	type
séduisant	seductive
celui	the
épaules	shoulders
d'athlète	athlete
ajouta	added
déclenchant	triggering
nouveaux	new
gloussements	chuckles
trop	too
bête	beast
aligner	align
lança	launched
fred	fred
irrité	irritated
vois	see
t'inquiètes	don't worry
faciles	easy
battre	beat
joué	played
attrapé	caught
vif	bright
d'or	gold
bout	end
cinq	five
souviens-toi	remember
jouait	played
conditions	conditions
différentes	different
s'écria	cried
exorbités	bulging
réussi	successful
constituer	be
bonne	good
excellent	excellent
j'avais	I had
justement	precisely
preniez	take
surtout	especially
déconcentrer	distract
rassembler	gather
forces	forces
essaient	try
déstabiliser	destabilize
pouvons	can
permettre	allow
calme-toi	be quiet, you
inquiet	worried
crois-moi	believe me
prenons	take
sérieux	serious
veille	eve
mit	mit
hurler	scream
tomba	fell
dru	dru
faisait	was
sombre	dark
l'intérieur	inside
fallut	took
allumer	turn on
torches	torches
lanternes	lanterns
supplémentaires	additional
joueurs	players
affichaient	posted
supérieurs	senior
ah	ah
seulement	only
mon	my
mal	evil
soupirait-il	sighed-it
fenêtres	windows
tremblaient	the trembling
n'avait	had
souci	concern
lendemain	next day
précipitait	rush
classes	classes
donner	give
conseils	tips
troisième	third
l'intercepta	the intercepted
ainsi	as well
retint	retained
longuement	long
s'aperçut	saw
manqué	missed
cours	during
défense	defence
courir	run
crier	shout
vire	vire
rapidement	quickly
faudrait	should
essayes	try
contourner	work around
s'arrêta	stopped
glissade	slide
devant	before
classe	class
rua	rua
désolé	sorry
lupin	lupin
commença-t-il	he began
assis	sitting
commencé	started
donc	so
enlever	remove
points	points
retard	delay
asseyez-vous	sit
bougea	moved
demanda-t-il	he asked
sentait	felt
assez	enough
ses	its
aujourd'hui	today
rictus	grin
semble	seems
asseoir	sit
noirs	black
étincelèrent	sparkled
mette	mette
vie	life
danger	danger
répondit-il	he replied
regrettait	regretted
j'enlève	I take off
dois	do
cinquante	fifty
s'avança	advanced
lentement	slowly
s'asseoir	sit
disais	said
interrompe	interrupt
reprit	took
laissé	left
aucune	no
indication	indication
sujets	topics
étudier	study
jusqu'à	up to
étudié	studied
épouvantards	épouvantards
strangulots	strangulots
commença	started
taisez-vous	shut up, you
l'interrompit	the interrupted
sec	dry
demandé	asked
voulais	wanted
simplement	simply
mettre	put
manque	lack
d'organisation	organization
meilleur	best
ayons	have
eu	had
bravement	bravely
approbateur	approver
répandit	spread
menaçant	threatening
contentez	just
surcharge	overload
travail	work
apprendre	learn
défendre	defend
niveau	level
première	first
année	year
allons	will
plutôt	rather
feuilleter	browse
manuel	manual
jusqu'au	until the
chapitre	chapter
loups-garous	werewolves
intervint	intervened
incapable	unable
retenir	remember
devions	had to
vite	fast
devait	should
consacré	dedicated
miss	miss
granger	granger
coupa	cut
glacial	icy
moi	me
donne	gives
d'ouvrir	open
livres	books
page	page
394	394
balaya	swept
obéirent	obey
échangeant	exchanging
regards	looks
maussades	moody
quelques	a few
réflexions	reflections
teintées	tinted
d'amertume	bitterness
distingue	distinguished
loup-garou	loup-garou
vrai	true
loup	wolf
sauf	except
habitude	usual
ignorant	ignoring
délibérément	deliberately
eut	had
cela	this
signifie-t-il	does it mean
enseigné	taught
différences	differences
élémentaires	elementary
n'avions	did
parvati	parvati
silence	silence
grogna	" 
eh	eh
n'aurais	would have
pensé	thought
reconnaître	recognize
manquerai	miss
d'informer	to inform
plaît	please
gardé	kept
levée	lifting
petites	small
museau	muzzle
parlez	talk
invitée	invited
glaciale	icy
attitude	attitude
coûtera	cost
mademoiselle	mademoiselle
je-sais-tout	I-know-it-all
devint	became
écarlate	scarlet
baissa	lowered
plancher	floor
larmes	tears
l'avait	had
appelée	called
inspirait	inspired
telle	such
aversion	aversion
noir	black
traitait	dealt with
semaine	week
prit	took
posé	asked
réponse	response
voulez	want to
dise	say
camarades	comrades
surent	knew
allé	gone
aurez	will
retenue	withholding
doucereuse	sugary
approchant	approaching
près	near
entends	hear
critiquer	criticize
regretterez	regret
amèrement	bitterly
fin	end
prononça	spoke
moindre	less
contentèrent	content
prendre	take
notes	notes
arpentait	strode
travées	span
examinant	examining
expliqué	explained
exact	exact
kappa	kappa
trouve	find
généralement	generally
mongolie	mongolia
mis	put
seize	sixteen
vingt	twenty
vaut	worth
six	six
cloche	bell
sonna	rang
instants	moments
ferez	will
devoir	duty
veux	want to
rouleaux	rolls
parchemin	parchment
sujet	about
lundi	Monday
reprenne	resume
restez	stay
sortirent	went out
sûrs	safe
n'être	not to be
entendus	heard
tirades	tirades
multiplièrent	multiplied
convoite	covet
tellement	so
cause	cause
l'épouvantard	the épouvantard
songeur	pensive
j'espère	I hope
remis	given
rattrapa	caught
écumant	foaming
rage	rage
nettoie	cleans
bassins	basins
l'infirmerie	the infirmary
interdiction	ban
d'avoir	to have
recours	use
rugit-il	roars-it
poings	fists
serrés	tight
respiration	breathing
saccadée	jerky
débarrassés	rid
réveilla	woke up
tôt	early
crut	believed
mugissement	roar
réveillé	woke up
sentit	felt
d'air	air
froid	cold
nuque	neck
redressa	straightened
brusquement	suddenly
peeves	peeves
l'esprit	the spirit
frappeur	batting
flottait	floated
côté	side
soufflait	blew
violemment	violently
protesta	protested
gonfla	gonfla
joues	cheeks
souffla	blew
fila	fila
arrière	rear
fusée	rocket
caquetant	cackling
petite	small
aiguë	acute
attrapa	caught
réveil	alarm clock
tâtons	groping
cadran	dial
quatre	four
demie	half
maudissant	cursing
recoucha	lay down again
essaya	tried
rendormir	back to sleep
entendait	heard
fracas	crash
coups	shots
l'assaut	the assault
craquement	crunch
lointain	distant
arbres	trees
forêt	forest
interdite	prohibited
lutter	fight
bourrasque	squall
finit	ends
renoncer	waive
sommeil	sleep
s'habilla	dressed
nimbus	nimbus
2000	2000
sortit	went out
dortoir	dormitory
frôla	nearly
jambe	leg
pencha	bent
attraper	catch
pattenrond	pattenrond
queue	tail
touffue	bushy
tirer	shoot
dehors	outside
chat	cat
plein	full
souris	mouse
laisse	leaves
croûtard	croûtard
poussa	pushed
pied	foot
bas	the bottom
l'escalier	the stairs
colimaçon	spiral
commune	common
retentissait	there was a tremendous burst
annulé	cancelled
n'annulait	only reversed
simple	simple
orage	storm
ressentait	felt
terrible	terrible
appréhension	apprehension
montré	shown
couloir	hallway
cinquième	fifth
attrapeurs	rat catchers
légers	light
rapides	fast
poids	weight
donnerait	would
avantage	advantage
car	because
risquait	could
dévier	swerve
trajectoire	path
l'aube	dawn
contemplant	contemplating
feu	fire
brûlait	burned
cheminée	fireplace
levait	rose
empêcher	prevent
glisser	drag
menait	led
attente	waiting
interminable	endless
estima	estima
l'heure	the time
descendre	down
petit	small
déjeuner	breakfast
l'ouverture	the opening
masquée	hidden
bâtard	bastard
galeux	mangy
suffit	just
répliqua	replied
bâillant	yawning
retrouva	found
avalant	swallowing
bol	bowl
céréales	cereals
lorsqu'il	when it
tartina	tartina
toast	toast
rejoignirent	joined
mangeait	ate
arrête	stop
t'inquiéter	worry
apaisant	soothing
arrêter	stop
qu'une	a
populaire	popular
vint	came
d'habitude	usually
cols	passes
relevés	statements
têtes	heads
baissées	lowered
parapluies	umbrellas
déployés	deployed
d'entrer	to enter
vestiaires	locker rooms
crabbe	crabbe
goyle	goyle
montraient	showed
doigt	finger
s'esclaffant	asserted and burst out laughing
l'abri	the shelter
immense	huge
parapluie	umbrella
revêtirent	put
robes	dresses
écarlates	scarlet
attendirent	waited for
l'habituel	the usual
discours	speech
d'encouragement	encouragement
qu'olivier	olivier
réservait	reserved
cette	this
fois-ci	time
pourtant	yet
durent	last
dispenser	provide
parler	talk
plusieurs	several
reprises	times
parvint	managed
qu'à	as
émettre	issue
borborygmes	growlings
hocher	nod
résigné	resigned
faisant	making
signe	sign
suivre	follow
violent	violent
entrèrent	went
chancelant	tottering
vacarme	din
couvrait	covered
acclamations	cheers
public	public
ruisselait	streamed
lunettes	glasses
pourrait-il	could it
apercevoir	see
ces	these
apparurent	appeared
jaune	yellow
canari	canary
capitaines	captains
équipes	teams
s'avancèrent	advanced
serrèrent	shook
adressa	addressed
sourire	smile
celui-ci	it
semblait	seemed
crampe	cramp
mâchoire	jaw
capable	able
lut	lut
enfourchez	hop on
balais	brushes
arracha	tore
droit	right
gadoue	slush
passa	spent
par-dessus	above
manche	sleeve
donna	donna
sifflet	whistle
tempête	storm
décollèrent	they took off
balai	broom
maintenir	maintain
cap	cape
mieux	better
possible	possible
décrivit	described
courbe	curve
plissant	squinting
tombait	fell
verse	pays
glacé	glossy
trempé	tempered
jusqu'aux	up to
os	os
arrivait	arrived
minuscule	tiny
sillonnant	criss-crossing
l'espace	the space
au-dessus	above
formes	forms
rouges	red
jaunes	yellow
contours	contours
indécis	undecided
déroulait	place
hurlement	howl
l'empêchait	the prevented
d'entendre	to hear
commentaire	comment
foule	crowd
spectateurs	spectators
cachée	hidden
océan	ocean
capes	capes
faillit	almost
cognard	cognard
ruisselantes	rushing
vus	seen
venir	come
perdit	lost
devenait	became
difficile	difficult
s'assombrissait	darkened
décidé	decided
tomber	fall
d'avance	advance
collision	collision
s'agissait	was
d'adversaires	opponents
trempés	soaked
dense	dense
n'arrivait	there was
distinguer	distinguish
retentit	sounds
qu'un	a
éclair	flash
illuminait	illuminated
aperçut	saw
silhouette	silhouette
complet	complete
atterrit	lands
éclaboussures	splash
boue	mud
rugit	roars
rassemblèrent	together
bord	edge
profita	took advantage
ôter	remove
essuyer	wipe
pan	pan
robe	dress
sorcier	sorcerer
score	score
n'attrape	don't catch
bientôt	soon
veux-tu	do you want to
voie	way
exaspéré	enraged
agitant	waving
apparut	appeared
cape	cape
protéger	protect
ravie	happy
donne-moi	give me
tes	your
tendit	handed
tapoter	tap
verres	glasses
marmonnant	mumbling
impervius	impervius
voilà	this is
rendant	making
désormais	now
vont	go
repousser	push
l'eau	the water
allait	would
précipiter	rush
l'embrasser	the kiss
formidable	great
lança-t-il	"he shouted,
rauque	hoarse
qu'hermione	as hermione
disparaissait	disappeared
sortilège	hex
d'hermione	of hermione
engourdi	numb
normalement	normally
animé	animated
énergie	energy
fendit	split
remous	whirlpool
l'orage	the storm
jetant	throwing
d'œil	eye
quête	quest
évitant	avoiding
plongeant	plunging
filait	spinning
sens	meaning
inverse	reverse
accompagné	accompanied
fourchu	forked
dangereux	dangerous
fallait	had to
dépêcher	hurry
d'attraper	to catch
virage	turn
serré	tight
l'intention	the intention
revenir	return
milieu	middle
illumina	illumina
tribunes	forums
détourna	away
haut	top
gradin	gradin
vide	empty
énorme	huge
hirsute	shaggy
détachait	detached
nettement	clearly
mains	hands
engourdies	numb
bref	brief
plongeon	dip
mouvement	movement
rejeta	rejected
mèche	wick
trempée	soaked
barrait	gone
front	front
plissa	wrinkled
disparu	gone
hurla	screamed
angoissée	anguished
gardait	kept
buts	goals
toi	you
tourna	turned
vitesse	speed
direction	management
point	point
doré	golden
scintillait	sparkled
brusque	sudden
panique	panic
coucha	lay down
fonça	rushed
vas-y	vas-y
murmura-t-il	he murmured
fouetté	whipped
d'étrange	strange
produisait	produced
inquiétant	worrying
abattu	shot
stade	stage
fût	was
cessé	stopped
mugir	low
coupé	cut
devenu	now
sourd	deaf
vague	wave
l'envahir	the invade
pénétra	penetrated
fond	background
lui-même	himself
terriblement	terribly
familier	familiar
conscience	consciousness
bougeait	moved
détacha	detached
centaine	hundred
faces	faces
encagoulées	encagoulées
levées	lifted
tenaient	held
eau	water
glacée	ice
déversait	figure
poitrine	chest
déchirait	tearing
entrailles	bowels
criait	shouted
femme	woman
supplie	beg
pousse-toi	push yourself
espèce	species
d'idiote	stupid
tuez-moi	kill me
cerveau	brain
brouillard	fog
blanchâtre	whitish
tourbillonnait	swirling
faisait-il	was it
volait-il	flying-it
secours	relief
mourir	die
l'assassiner	the murder
ayez	have
pitié	pity
suraiguë	shrill
rire	laugh
n'entendit	heard
heureusement	fortunately
amorti	cushioning
chute	fall
cru	raw
tué	killed
cassées	broken
murmuraient	murmured
comprenait	included
qu'elles	they
disaient	said
l'endroit	the place
trouvait	was
ni	or
arrivé	arrived
auparavant	previously
centimètre	cm
carré	square
corps	body
roué	beaten
effrayante	scary
j'aie	I have
vue	view
ma	my
silhouettes	silhouettes
hurlements	howling
s'ouvrirent	opened
allongé	lying
lit	bed
maculés	stained
pieds	feet
rassemblés	gathered
également	also
présents	present
l'air	the air
piscine	swimming pool
teint	complexion
livide	livid
taches	spots
couvraient	covered
te	te
mémoire	memory
mise	update
fonctionner	function
accéléré	accelerated
l'éclair	the flash
sinistros	sinistros
redressant	straightening
sursauta	gasped
es	es
tombé	fallen
quinzaine	fifteen
mètres	meters
croyait	believed
étais	was
tremblant	tremblant
émit	issued
gémissement	moaning
suraigu	hyperacute
rejouer	replay
recevoir	receive
pierre	stone
pleine	full
perdu	lost
george	george
ta	your
rendu	rendering
compte	account
étendu	extended
essayé	tried
d'annuler	to cancel
rejoue	replays
victoire	victory
indiscutable	indisputable
reconnu	recognized
s'apercevoir	see
absence	absence
douche	shower
essaye	try
noyer	walnut
colla	colla
genoux	knees
prenant	taking
cheveux	hair
saisit	captures
l'épaule	the shoulder
secoua	shook
n'arrives	can't seem
arrive	happens
cent	cent
perd	loses
gagne	wins
perde	lose
d'au	at
cents	cents
remarquer	notice
s'ils	if they
battent	fighting
Ça	It
dépend	depends on
combien	how
perdent	lose
marge	margin
depuis	since
débuts	debut
dizaine	ten
pomfresh	pomfresh
visite	visit
terminée	complete
reviendra	return
fais	do
bile	bile
laissant	leaving
traces	traces
referma	closed
réprobateur	réprobateur
rapprochèrent	moved closer to the
tremblante	trembling
l'avais	had
cet	this
état	state
précipité	precipitated
tombais	fell
brandi	brandi
ralentir	slow down
touches	keys
ensuite	then
tourné	shot
trucs	tips
argentés	silver
quitté	left
soient	are
entrés	entered
t'a	you
brancard	stretcher
prononçant	speaking
formule	formula
flotter	float
pensait	thought
s'étouffa	choked
remarqua	noticed
l'effet	the effect
entendue	heard
l'observer	watch
inquiétude	concern
préféra	preferred
changer	change
récupéré	retrieved
échangèrent	exchanged
heu	uh
quoi	what
emporté	away
hésitant	hesitating
désolée	sorry
saule	willow
cogneur	slugger
contracter	contract
arbre	tree
extrêmement	extremely
planté	planted
répéta	repeated
redoutant	fearing
connais	know
n'aime	likes
tombe	falls
dessus	top
rapporté	reported
reprennes	reprennes
connaissance	knowledge
sac	bag
retourna	returned
douzaine	dozen
morceaux	pieces
bois	wood
brindilles	twigs
brisés	broken
restait	remained
fidèle	faithful
vaincu	defeated
