5	5
le	the
dÉtraqueur	dÉtraqueur
lendemain	next day
tom	tom
réveilla	woke up
harry	harry
avec	with
son	its
habituel	usual
sourire	smile
édenté	toothless
et	and
une	a
tasse	cup
de	of
thé	tea
préféré	favorite
fois	time
habillé	dressed
tentait	tried
à	to
grand-peine	great difficulty
convaincre	convince
hedwige	hedwig
d'entrer	to enter
dans	in
sa	its
cage	cage
lorsque	when
ron	ron
fit	fit
irruption	burst
la	the
chambre	room
d'humeur	mood
massacrante	massacring
il	it
était	was
en	in
train	train
d'enfiler	donning
un	a
pull	pull
vivement	strongly
qu'on	we
soit	either
lança-t-il	"he shouted,
au	the
moins	less
quand	when
on	it
sera	will be
arrivés	arrived
poudlard	hogwarts
je	I
pourrai	can
éviter	avoid
d'avoir	to have
percy	percy
sur	on
dos	back
maintenant	now
m'accuse	accuses me
renversé	reversed
du	the
photo	photo
pénélope	penelope
deauclaire	deauclaire
petite	small
amie	friend
ajouta-t-il	he added
grimace	grin
elle	it
se	is
cache	cache
derrière	behind
cadre	framework
parce	because
qu'elle	it
a	has
bouton	button
nez	nose
j'ai	I
quelque	some
chose	thing
te	te
dire	say
commença	started
mais	but
fut	was
interrompu	interrupted
par	by
fred	fred
george	george
qui	that
étaient	were
venus	come
féliciter	congratulate
rendu	rendering
nouveau	new
furieux	furious
ils	they
descendirent	went down
prendre	take
leur	their
petit	small
déjeuner	breakfast
salle	room
chaudron	cauldron
baveur	leaky
où	where
mr	mr
weasley	weasley
lisait	read
gazette	gazette
sorcier	sorcerer
fronçant	frowned
les	the
sourcils	eyebrows
tandis	while
que	that
mrs	mrs
racontait	told
hermione	hermione
ginny	ginny
avait	had
fabriqué	manufactured
philtre	potion
d'amour	love
lorsqu'elle	when it
jeune	young
toutes	all
trois	three
avaient	had
l'air	the air
bien	well
s'amuser	have fun
qu'est-ce	what is this
tu	you
voulais	wanted
me	me
demanda	asked
plus	more
tard	later
murmura	whispered
voyant	light
arriver	getting
d'un	a
pas	not
impérial	imperial
l'agitation	the hustle and bustle
départ	starting
n'avait	had
aucune	no
chance	chance
pouvoir	power
parler	talk
tranquillement	quietly
trop	too
occupés	occupied
descendre	down
leurs	their
valises	suitcases
entasser	crowd
devant	before
porte	door
cages	cages
d'hedwige	of hedwig
d'hermès	hermes
hibou	owl
posées	asked
dessus	top
côté	side
montagne	mountain
bagages	luggage
y	there
panier	basket
d'osier	wicker
d'où	where
s'échappaient	escaped
des	of
crachements	coughing
calme	quiet
pattenrond	pattenrond
susurra	whispered
penchée	leaning
laisserai	let
sortir	out
certainement	certainly
trancha	cut
oublies	forget
ce	this
pauvre	poor
croûtard	croûtard
montra	showed
poche	pocket
dont	which
renflement	bulge
indiquait	indicated
présence	presence
rat	rat
resté	stayed
dehors	outside
pour	for
guetter	watch
l'arrivée	the arrival
voitures	cars
passa	spent
tête	head
l'intérieur	inside
elles	they
sont	are
là	there
dit-il	he said
viens	just
accompagna	accompanied
trottoir	sidewalk
jusqu'à	up to
première	first
deux	two
vert	green
foncé	dark
carrosserie	body
peu	little
démodée	old-fashioned
conduites	pipes
sorciers	wizards
furtif	stealth
vêtus	dressed
uniforme	uniform
couleur	color
émeraude	emerald
entre	between
dit	said
jetant	throwing
regards	looks
côtés	sides
rue	street
bondée	crowded
s'assit	sat
l'arrière	the rear
voiture	car
bientôt	soon
rejoint	joined
–	-
grand	great
déplaisir	displeasure
trajet	journey
gare	station
king's	king's
cross	cross
déroula	took place
paisiblement	peacefully
comparé	compared
voyage	travel
magicobus	magicobus
ministère	department
magie	magic
semblaient	seemed to
presque	almost
ordinaires	common
qu'elles	they
fussent	were
capables	capable
glisser	drag
espaces	spaces
nouvelle	new
l'oncle	uncle
vernon	vernon
aurait	would
été	been
peine	penalty
s'aventurer	venturing
arrivèrent	arrived
vingt	twenty
minutes	minutes
d'avance	advance
chauffeurs	drivers
trouvèrent	found
chariots	carts
lesquels	which
disposèrent	had
puis	then
soulevèrent	rose
casquette	cap
saluer	greet
s'en	in
allèrent	went
s'arrangeant	arranging
retrouver	find
premiers	first
feu	fire
rouge	red
malgré	despite
l'intensité	the intensity
circulation	traffic
ne	do
lâcha	released
d'une	a
semelle	outsole
comme	as
nous	we
sommes	are
très	very
nombreux	many
va	will
passer	pass
surveillant	monitoring
alentours	around
vais	'll
franchir	cross
barrière	barrier
premier	first
s'avança	advanced
vers	to
magique	magic
quais	docks
9	9
10	10
poussant	pushing
lui	him
chariot	cart
regard	look
entendu	heard
s'appuya	leaned
négligemment	carelessly
contre	against
l'imita	the imita
instant	now
passés	past
travers	through
l'obstacle	the obstacle
métal	metal
trouvaient	were
présent	this
quai	dock
3/4	3/4
locomotive	locomotive
vapeur	steam
vif	bright
soufflait	blew
panaches	plumes
fumée	smoke
flottaient	floating
au-dessus	above
encombré	crowded
sorcières	witches
installer	install
enfants	children
express	express
tout	all
essoufflés	out of breath
surgirent	arose
soudain	suddenly
apparemment	apparently
couru	ran
ah	ah
voilà	this is
lissant	smoothing
ses	its
cheveux	hair
joues	cheeks
légèrement	slightly
rosés	rosé
croisa	crossed
tous	all
détournèrent	away
cacher	hide
fou	crazy
rire	laugh
s'avancer	advance
conquérant	conqueror
fille	girl
aux	the
longs	long
bouclés	curly
bombait	bombait
poitrine	chest
puisse	can
ignorer	ignore
insigne	badge
étincelant	sparkling
reste	rest
famille	family
ainsi	as well
qu'hermione	as hermione
eurent	had
rejoints	joined
ouvrirent	opened
marche	walking
jusqu'au	until the
bout	end
convoi	convoy
enfin	finally
wagon	car
paraissait	seemed
vide	empty
chargèrent	charged
casèrent	casèrent
filet	net
redescendirent	climbed back down
revoir	review
embrassa	kissed
serra	serra
fais	do
attention	attention
toi	you
dit-elle	she said
yeux	eyes
étrangement	strangely
brillants	brilliant
ouvrit	opened
alors	then
énorme	huge
sac	bag
main	hand
ajouta	added
vous	you
ai	I
préparé	prepared
sandwiches	sandwiches
tiens	want
t'inquiète	don't worry
n'ai	haven
mis	put
corned	corned
beef	beef
es-tu	are you
voir	see
mi-voix	mi-voice
signe	sign
direction	management
pilier	pillar
rejoignit	joined
laissant	leaving
autres	other
autour	around
faut	must
dise	say
avant	before
partes	partes
reprit	took
voix	voice
tendue	tense
inquiétez	worry
répondit	replied
suis	am
déjà	already
courant	current
comment	how
l'as-tu	did you
appris	learned
hier	yesterday
soir	evening
sans	without
vouloir	want to
précipitamment	hurriedly
désolé	sorry
n'est	there is
cette	this
façon	how
j'aurais	I would have
voulu	wanted
l'annoncer	the announce
anxieux	anxiety
Ça	It
fait	fact
rien	nothing
c'est	it is
même	even
ça	it
aurez	will
tenu	view
votre	your
parole	word
vis-à-	vis-à-
vis	screw
fudge	fudge
moi	me
sais	know
passe	pass
dois	do
avoir	have
peur	fear
non	not
sincèrement	sincerely
assure	ensures
incrédule	incredulous
n'essaye	try
jouer	play
héros	hero
finalement	finally
sirius	sirius
black	black
peut	can
être	be
dangereux	dangerous
voldemort	voldemort
tressaillit	flinched
l'entendant	the hearing
prononcer	pronounce
nom	name
si	if
n'était	there was
savais	knew
étais	was
solide	solid
pense	think
content	content
n'aies	hast
arthur	arthur
appela	called
monter	mount
aller	go
arrive	happens
molly	molly
retourna	returned
parlant	speaking
basse	low
précipitée	precipitated
Écoute-moi	Listen to me
donner	give
ta	your
ferai	will
bêtises	nonsense
resterai	will stay
château	castle
acheva	completed
ton	your
lugubre	gloomy
seulement	only
jamais	never
paru	published
aussi	also
grave	serious
jure-moi	swear me
n'essaieras	not essaieras
quoi	what
ouvrant	opening
ronds	round
eut	had
coup	blow
sifflet	whistle
sonore	sound
employés	employees
avançaient	advanced
long	long
fermant	closing
portières	doors
promets-moi	promise me
insista	insisted
vite	fast
qu'il	it
pourquoi	why
est-ce	is this
j'essaierais	I would try
quelqu'un	someone
veut	wants to
tuer	kill
répliqua	replied
neutre	neutral
s'exclama	exclaimed
jet	jet
s'ébranla	will shook
courut	ran
portière	door
ouverte	open
sauta	jumped
penchèrent	immediately
fenêtre	window
faisant	making
grands	great
signes	signs
prenne	take
virage	turn
déroba	stole
vue	view
parle	speaks
va-t'en	go
merci	thank you
gentil	nice
air	air
offensé	offended
s'éloigner	away
raide	stiff
digne	worthy
avancèrent	forth
couloir	hallway
recherche	search
compartiment	compartment
pleins	full
sauf	except
dernier	last
celui-ci	it
qu'un	a
seul	only
occupant	occupant
homme	man
profondément	deeply
endormi	asleep
assis	sitting
près	near
s'immobilisèrent	if immobilisèrent
l'entrée	the entry
d'habitude	usually
réservé	reserved
élèves	students
n'avaient	had
encore	yet
vu	seen
d'adultes	adults
parmi	among
passagers	passengers
l'homme	the man
portait	wore
robe	dress
miteuse	shabby
rapiécée	repaired
plusieurs	several
endroits	places
semblait	seemed
malade	sick
épuisé	exhausted
fût	was
châtains	brown
parsemés	dotted
mèches	wicks
blanches	white
avis	notice
qu'ils	they
s'asseyaient	sat
l'autre	the other
après	after
refermé	closed
coulissante	sliding
professeur	professor
r	r
j	j
lupin	lupin
chuchota	whispered
aussitôt	as soon
écrit	written
valise	suitcase
lequel	which
rangée	row
vieille	old
cabossée	dented
entourée	surrounded
longue	long
ficelle	string
soigneusement	carefully
nouée	knotted
coins	corners
lettres	letters
commençaient	started
s'écailler	flake
demande	request
enseigne	teaches
froncés	a frown
observant	observing
visage	face
livide	livid
paraît	seems
évident	obvious
poste	post
vacant	vacant
défense	defence
forces	forces
mal	evil
eu	had
professeurs	teachers
matière	material
chacun	each
d'eux	of them
qu'une	a
seule	only
année	year
d'après	after
rumeur	rumor
c'était	it was
maudit	cursed
j'espère	I hope
hauteur	height
grande	great
conviction	conviction
l'impression	printing
suffirait	would
jeter	throw
sort	fate
rende	make
soupir	sigh
tournant	turning
résuma	summed up
discussion	discussion
surprise	surprise
l'avertissement	the warning
venait	came
lorsqu'il	when it
terminé	finished
abasourdi	stunned
mains	hands
plaquées	plated
bouche	mouth
d'effarement	of dismayed
s'est	is
évadé	escaped
vraiment	really
sois	am
prudent	careful
cherche	looking
ennuis	trouble
aucun	no
ennui	boredom
agacé	annoyed
généralement	generally
trouvent	find
faudrait	should
idiot	idiot
chercher	search
cinglé	crazy
tremblante	trembling
surpris	surprised
réaction	reaction
faire	do
beaucoup	a lot
qu'à	as
personne	person
sait	knows
s'y	there
est	is
pris	taken
s'évader	escape
d'azkaban	of azkaban
l'aise	comfortable
réussi	successful
quartier	district
haute	high
sécurité	security
vont	go
finir	finish
l'attraper	the catch
moldus	muggle
recherchent	looking for
bruit	noise
entendait	heard
effet	effect
sorte	so
sifflement	whistle
métallique	metal
regardèrent	looked
vient	comes
leva	rose
alla	alla
d'oeil	eye
sortit	went out
scrutoscope	scrutoscope
l'objet	the object
tournait	turned
toute	any
vitesse	speed
paume	palm
émettant	emitting
lumière	light
brillante	brilliant
intéressé	interested
s'approchant	approaching
mieux	better
celui-là	this one
plutôt	rather
bon	good
marché	market
tourner	turn
raison	reason
l'ai	I
attaché	attached
patte	paw
d'errol	of errol
l'envoyer	send
avais	had
mauvaises	bad
intentions	intentions
moment	time
passé	past
normalement	normally
n'avais	had
droit	right
d'utiliser	use
errol	errol
supporte	supports
voyages	travel
pouvais	could
d'autre	on the other
envoyer	send
cadeau	gift
remets-le	hand in the
conseilla	advised
sifflait	whistled
fort	fort
sinon	otherwise
réveiller	wake up
remit	gave
chaussettes	socks
étouffèrent	choked
fera	will
examiner	review
ira	ira
pré-au-lard	pre-to-bacon
suggéra	suggested
rasseyant	rasseyant
m'ont	I have
vendent	sell
genre	kind
trucs	tips
chez	in
derviche	dervish
bang	bang
magasin	store
d'objets	objects
magiques	magic
avidité	greed
lu	read
village	village
d'angleterre	of england
n'y	there
moldu	muggle
oui	yes
crois	believe
vrai	true
dégagé	loose
veux	want to
m'intéresse	I am interested
d'aller	go
tour	tour
honeydukes	honeydukes
confiserie	confectionery
rêveur	dreamer
ont	have
absolument	absolutely
gnomes	gnomes
poivre	pepper
font	do
souffler	blow
manges	eat
d'énormes	huge
chocoballes	chocoballes
pleines	full
mousse	foam
fraise	strawberry
plumes	feathers
sucre	sugar
sucer	suck
classe	class
semblant	pretend
réfléchir	think
endroit	place
passionnant	exciting
sites	sites
historiques	historical
sorcellerie	witchcraft
l'auberge	the hostel
servi	served
général	general
l'époque	the time
révolte	revolt
gobelins	goblins
1612	1612
cabane	hut
hurlante	howling
impressionnantes	impressive
maisons	houses
hantées	haunted
pays	country
grosses	large
boules	balls
sorbet	sorbet
permettent	allow
s'élever	rise
quelques	a few
centimètres	centimeters
sol	soil
lèche	licks
poursuivit	continued
écouté	listened to
mot	word
qu'avait	that was
celle-ci	it
tourna	turned
l'école	the school
visiter	visit
sûrement	surely
soupira	sighed
raconterez	tell
reviendrez	return
s'étonna	was surprised
dursley	dursley
n'ont	have
signé	signed
mon	my
autorisation	authorization
également	also
refusé	refused
sembla	seemed
horrifié	horrified
n'auras	there will
impossible	impossible
mcgonagall	mcgonagall
ou	or
donnera	give
permission	permission
amer	bitter
directrice	director
maison	home
gryffondor	gryffindor
particulièrement	particularly
stricte	strict
demandera	ask
connaissent	know
passages	passages
secrets	secrets
s'indigna	grew indignant
serait	would be
clandestinement	secretly
trousses	kits
répondra	answer
demanderai	ask
marmonna	muttered
sombrement	darkly
enjoué	playful
n'osera	do not dare
raconte	tells
sèchement	curtly
assassiné	murdered
tas	heap
gens	people
milieu	middle
pleine	full
monde	world
gênera	interfere
attaquer	attack
simplement	simply
serons	will be
tripotait	tripotait
fermeture	closure
transporté	transported
laisse	leaves
truc-là	thing right here
protesta	protested
chat	cat
glissa	slipped
hors	out
s'étira	stretched
bâilla	yawned
genoux	knees
mit	mit
trembler	shake
repoussa	pushed
geste	gesture
fiche	sheet
camp	camp
arrête	stop
colère	anger
s'apprêtait	was about
répondre	reply
lorsqu'ils	when they
entendirent	heard
bouger	move
l'observèrent	the observed
inquiétude	concern
contenta	contenta
entrouverte	ajar
poursuivait	continued
chemin	path
nord	north
paysage	landscape
au-dehors	outside
devenait	became
sauvage	wild
sombre	dark
cause	cause
nuages	clouds
s'amoncelaient	fattened
d'autres	other
passaient	passed
repassaient	repassaient
gré	option
déambulations	wanderings
s'était	had
installé	installed
siège	seat
museau	muzzle
écrasé	crushed
tourné	shot
jaunes	yellow
fixés	set
trouvait	was
heure	time
sorcière	witch
replète	replète
apparut	appeared
rempli	filled
boissons	drinks
nourriture	food
croyez	believe
devrait	should
montrant	showing
ferait	would
peut-être	maybe
manger	eat
s'approcha	approached
précaution	caution
heu	uh
excusez-moi	excuse me
bougea	moved
t'en	you
ma	my
chérie	sweetheart
tendait	tended
gros	wholesale
paquet	package
gâteaux	cakes
s'il	if it
faim	hunger
réveillera	wake up
serai	am
machiniste	machinist
j'imagine	I guess
mort	death
respire	breathe
prenant	taking
gâteau	cake
donnait	gave
compagnie	company
passionnante	exciting
avantages	benefits
l'après-midi	in the afternoon
pluie	rain
commençait	started
tomber	fall
brouillant	blurring
collines	hills
traversait	crossed
bruits	noise
personnages	characters
appréciaient	appreciated
montrèrent	showed
drago	drago
malefoy	malfoy
encadré	box
inséparables	inseparable
vincent	vincent
crabbe	crabbe
gregory	gregory
goyle	goyle
devenus	become
ennemis	enemies
depuis	since
ensemble	all
pointe	tip
méprisant	despising
appartenait	belonged
serpentard	slytherin
jouait	played
attrapeur	monkey net
l'équipe	the team
quidditch	quidditch
qu'occupait	that was
utilité	utility
vie	life
d'obéir	to obey
massifs	massive
musculeux	muscular
coupe	cup
bol	bowl
cou	neck
épais	thick
raides	stiff
courts	short
bras	arm
donnaient	gave
silhouette	silhouette
gorille	gorilla
regardez	watch
lança	launched
habituelle	usual
traînante	shuffling
potter	potter
poteau	post
s'esclaffèrent	hooted with laughter when they
troll	troll
père	father
procurer	buy
d'or	gold
cet	this
mère	mother
morte	dead
sous	under
choc	shock
brusquement	suddenly
terre	earth
émit	issued
grognement	grunt
reculant	backing up
machinalement	going through the motions
prof	prof
levé	survey
cas	case
fallu	had to
retenir	remember
disais	said
plissa	wrinkled
pâles	pale
suffisamment	enough
provoquer	cause
bagarre	brawl
venez	come
marmonna-t-il	mumbled to himself he
hargneux	surly
s'éloignèrent	wandered up to
rassirent	rassirent
décidé	decided
laisser	let
plaisante	pleasant
remarque	note
casse	case
mine	mine
violent	violent
poing	fist
toujours	always
intensifiée	intensified
recouvrant	covering
fenêtres	windows
surface	surface
grise	grey
luisante	shiny
s'obscurcissait	bruised
mesure	measurement
nuit	night
tombait	fell
lanternes	lanterns
s'allumaient	lit
filets	nets
grinçait	made a bad noise
ferraille	scrap
martelait	pounding
vent	wind
continuait	continued
dormir	sleep
doit	must
penchant	leaning
essayer	try
vitre	glass
devenue	become
complètement	completely
noire	black
avait-il	had he
fini	finished
ralentir	slow down
parfait	perfect
contournant	bypassing
meurs	die
festin	feast
m'étonnerait	I doubt
regardant	looking at
montre	watch
s'arrête	stops
pistons	pistons
s'estompait	faded
distinctement	distinctly
déchaîner	unleash
vitres	windows
regarder	watch
têtes	heads
sortaient	out
compartiments	compartments
passait	passed
s'arrêta	stopped
chocs	shocks
lointains	distant
indiquèrent	indicated
tombés	fallen
lampes	lamps
s'éteignirent	went out
plongé	immersed
totale	total
obscurité	darkness
ouille	ouch
m'as	me
pied	foot
s'asseoir	sit
tâtons	groping
panne	failure
n'en	do
couinement	squealing
distingua	distinguished
essuyait	wiped
plat	flat
mouvement	movement
commenta	commented
dirait	looks like
montent	mount
s'ouvrit	opened
tomba	fell
lourdement	heavily
savez	know
pardon	forgiveness
salut	hi
neville	neville
soulevant	lifting
pan	pan
cape	cape
idée	idea
assieds-toi	sit down
enragé	berserk
gémissement	moaning
douleur	pain
essayé	tried
demander	ask
d'hermione	of hermione
sentit	felt
entendit	heard
suivi	follow-up
cris	cree
cherchais	was looking for
ici	here
silence	silence
rauque	hoarse
s'être	will be
réveillé	woke up
l'entendait	the intended
coin	corner
tut	tut
faible	low
craquement	crunch
lueur	glow
éclaira	lit
tenait	held
creux	hollow
poignée	handle
flammes	flames
illuminaient	illuminated
gris	grey
fatigué	tired
vifs	bright
cependant	however
alerte	alert
restez	stay
êtes	are
lentement	slowly
tenant	taking into
ait	has
temps	time
l'atteindre	the reach
debout	standing
l'encadrement	coaching
éclairée	lit
vacillantes	flickering
dressait	was
enveloppée	wrapped
entièrement	fully
dissimulé	concealed
cagoule	hood
venu	come
touchait	touched
plafond	ceiling
baissa	lowered
vit	lives
l'estomac	the stomach
dépassait	exceeded
grisâtre	greyish
visqueuse	viscous
couverte	covered
croûtes	crusts
putréfiée	out rotten
l'eau	the water
pendant	during
fraction	fraction
seconde	second
créature	creature
senti	felt
disparut	disappeared
plis	folds
l'étoffe	the fabric
l'être	the be
prit	took
lente	slow
inspiration	inspiration
produisit	produced
râle	rattle
essayait	tried
d'aspirer	suck
autre	other
froid	cold
intense	intense
envahit	invades
propre	own
souffle	breath
figer	freeze
peau	skin
répandait	spread
corps	body
crépitement	crackling
semblable	similar
chute	fall
d'eau	water
retentit	sounds
oreilles	ears
tirait	drew
pieds	feet
grondement	rumble
s'intensifiait	intensified
loin	far
terribles	terrible
hurlements	howling
terrifiés	terrified
implorants	implorants
porter	wear
secours	relief
hurlait	screaming
essaya	tried
s'aperçut	saw
paralysé	paralyzed
brouillard	fog
blanc	white
l'enveloppait	the enveloped
s'insinuait	if implied
tapes	tapes
qu	that
plancher	floor
vibrait	vibrated
reparti	left
lumières	lights
s'étaient	had
rallumées	again
tombé	fallen
glissé	slipped
agenouillés	kneeling
voyait	saw
regardaient	watched
sentait	felt
rajuster	adjust
lunettes	glasses
sueur	sweat
froide	cold
couvrait	covered
front	front
hissèrent	ascended
sens	meaning
anxieuse	anxious
disparu	gone
crié	shouted
n'a	did
inquiet	worried
regarda	looked at
brillamment	brilliantly
éclairé	informed
l'observaient	the observed
crier	shout
sursauter	jump
casser	break
morceaux	pieces
tablette	tablet
chocolat	chocolate
tenez	hold
tendant	for
morceau	song
mangez	eat
sentirez	feel
mangea	ate
demanda-t-il	he asked
détraqueur	détraqueur
distribuait	distributed
l'un	one
détraqueurs	détraqueurs
froissa	froissa
papier	paper
enveloppait	enveloped
répéta-t-il	he kept telling her
j'aille	I go
es	es
sûr	course
angoissé	anxious
comprends	understand
essuyant	wiping
regardé	watched
partout	everywhere
regardait	watched
puisqu'on	since we
cru	raw
attaque	attack
effrayé	scared
devenu	now
as	as
commencé	started
spasmes	spasms
moment-là	time
t'a	you
enjambé	bestridden
avancé	advanced
sorti	out
baguette	wand
allez-vous-en	are you going to-
bougé	moved
marmonné	mumbled
truc	trick
argenté	silver
volte-face	volte-face
parti	party
glissait	glided
patins	lace up
horrible	horrible
aiguë	acute
l'ordinaire	the ordinary
entré	entered
sensation	sensation
bizarre	weird
remuant	stirring
épaules	shoulders
visiblement	obviously
j'allais	I was going to
perdre	lose
l'envie	the desire
recroquevillée	curled up
affectée	affected
laissa	let
échapper	escape
sanglot	sob
d'elle	it
l'épaule	the shoulder
réconforter	comfort
gêné	embarrassed
mise	update
feuille	sheet
comprenait	included
fébrile	febrile
sortait	out
mauvaise	bad
grippe	flu
éprouvait	felt
vague	wave
honte	shame
s'était-il	was he
effondré	collapsed
supporté	supported
revint	returned
rassurez-vous	don't worry
empoisonné	poisoned
croqua	croqua
éprouva	felt
chaleur	heat
répandit	spread
arriverons	get
dix	ten
annonça	announced
connaissait	knew
murmura-t-il	he murmured
parlèrent	spoke
fin	end
précipitèrent	ran
cohue	crush
hiboux	owls
hululaient	hululaient
chats	cats
miaulaient	miaulaient
crapaud	toad
caché	hidden
chapeau	hat
lançait	launched
coassements	coassements
sonores	sound
minuscule	tiny
faisait	was
glacial	icy
rideau	curtain
fine	fine
relâche	releases
familière	familiar
tournèrent	turned
gigantesque	gigantic
hagrid	hagrid
nouveaux	new
apeurés	frightened
suivre	follow
traditionnelle	traditional
traversée	crossing
lac	lake
cria	cried
firent	did
foule	crowd
compacte	compact
puissent	can
s'approcher	approach
suivirent	followed
boueux	muddy
centaine	hundred
diligences	due diligence
attendaient	waiting
devaient	had to
tirées	from
chevaux	horses
invisibles	invisible
pensa	thought
car	because
montaient	rose
refermaient	closing
mettaient	put
cahotant	several
procession	procession
odeur	smell
paille	straw
moisi	musty
flottait	floated
mangé	ate
cessaient	stopped
lancer	launch
s'ils	if they
s'évanouisse	faint
diligence	diligence
bringuebalant	clunky
magnifique	beautiful
portail	portal
fer	iron
forgé	forged
flanqué	flanked
colonnes	columns
pierre	stone
surmontées	overcome
sangliers	wild boar
ailés	adults
hautes	high
silhouettes	silhouettes
masquées	hidden
cagoules	hoods
garde	guard
chaque	each
glacée	ice
nauséeuse	nauseous
faillit	almost
l'engloutir	the swallow
dossier	folder
banquette	bench
défoncée	fucked
ferma	closed
attendant	waiting
aient	have
franchi	crossed
ensuite	then
l'allée	the aisle
pente	slope
douce	soft
menait	led
contemplait	contemplated
innombrables	countless
tours	towers
tourelles	turrets
rapprochaient	closer
oscillant	oscillating
roues	wheels
descendit	went down
suivie	followed
enjouée	playful
résonna	rang
pommes	apples
londubat	londubat
t'es	you're
évanoui	fainted
écarta	separated
coude	elbow
barrer	bar
marches	steps
l'escalier	the stairs
réjoui	pleased
narquoise	mocking
animait	animated
dégage	releases
dents	teeth
serrées	tight
vieux	old
contemplant	contemplating
insolent	insolent
oh	oh
répondit-il	he replied
sarcastique	sarcastic
adressa	addressed
goguenard	bantering
monta	went up
poussés	pushed
joignirent	joined
franchit	crosses
chêne	oak
s'engouffra	rushed
l'immense	the immense
hall	hall
d'entrée	input
torches	torches
enflammées	inflamed
escalier	staircase
marbre	marble
accès	access
étages	floors
droite	right
ouvrait	opened
suivit	followed
avait-	had-
nuageux	cloudy
soir-là	evening
granger	granger
voudrais	would like to
retournèrent	returned
assurait	ensured
cours	during
métamorphose	metamorphosis
occupait	occupied
fonction	function
rejoindre	join
d'apparence	appearance
sévère	severe
retenus	selected
chignon	bun
serré	tight
perçants	piercing
carrées	square
certaine	some
appréhension	apprehension
fraya	fraya
don	gift
naître	born
sentiment	feeling
culpabilité	guilt
inutile	useless
bureau	office
dit-	said
pouvez	can
rester	stay
besoin	need
bruyante	noisy
ceux-ci	these
furent	were
pièce	room
cheminée	fireplace
s'installer	install
elle-	it-
table	table
m'a	me
envoyé	sent
courrier	mail
spécial	special
m'informer	inform me
avez	have
malaise	discomfort
d'emblée	from the outset
frappa	hit
discrètement	discreetly
madame	mrs.
pomfresh	pomfresh
l'infirmière	the nurse
surgit	arises
rougir	blush
pénible	painful
surcroît	moreover
tant	as
d'histoires	stories
l'observer	watch
provoqué	caused
échangèrent	exchanged
hocha	hocha
désapprobateur	désapprobateur
poster	post
école	school
marmonna-t-elle	mumbled to himself it
posant	posing
s'évanouir	vanish
fiévreux	feverish
ces	these
créatures	creatures
désastreux	disastrous
personnes	people
fragiles	fragile
fragile	fragile
absent	absent
pouls	pulse
a-t-il	there
cassant	breaking
repos	rest
devrait-il	should it
l'infirmerie	the infirmary
levant	rising
bond	bond
imaginer	imagine
allait	would
l'envoyait	sent
mettait	put
supplice	torment
examinait	examined
pupilles	pupils
j'en	I
m'en	me
donné	given
approuva	approved
avons	have
connaît	knows
bons	good
remèdes	remedies
sentez	feel
assura	assura
attendez-moi	wait for me
miss	miss
propos	about
emploi	employment
descendrons	descend
participer	participate
ressortit	came out of it
s'éloigna	walked away
marmonnant	mumbling
paroles	lyrics
incompréhensibles	incomprehensible
n'eut	had
attendre	wait
réapparut	reappeared
ravie	happy
rassemblés	gathered
début	beginning
d'année	of the year
véritable	true
océan	ocean
chapeaux	hats
noirs	black
pointus	sharp
s'étendait	extended
eux	them
répartis	spread
selon	according to
longues	long
tables	tables
illuminé	illuminated
clarté	clarity
milliers	thousands
chandelles	candles
airs	air
flitwick	flitwick
tignasse	mop
blanche	white
emportait	carried
tabouret	stool
raté	missed
cérémonie	ceremony
répartition	distribution
différentes	different
grâce	thanks
choixpeau	sorting hat
mettre	put
annonçait	announced
adaptée	adapted
(gryffondor	(gryffindor
serdaigle	ravenclaw
poufsouffle	hufflepuff
serpentard)	slytherin)
enseignants	teachers
prirent	took
fond	background
quelques-uns	a few
doigt	finger
l'histoire	the story
évanouissement	fainting
dû	due
s'assirent	sat
gardé	kept
place	place
voulait	wanted
récit	story
directeur	director
discours	speech
dumbledore	dumbledore
déborder	overflow
d'énergie	energy
d'argent	money
barbe	beard
demi-lune	half-moon
aquilin	aquiline
souvent	often
présenté	presented
d'admiration	admiration
albus	albus
inspirait	inspired
infinie	infinite
confiance	trust
étudiants	students
retrouva	found
apparu	appeared
bienvenue	welcome
scintillante	shimmering
petites	small
choses	things
l'une	one
d'elles	they
sérieuse	serious
autant	as much
débarrasser	rid
suite	suite
bonne	good
chère	dear
plonge	plunges
euphorie	euphoria
propice	conducive
gravité	gravity
s'éclaircit	clears up
gorge	throat
pu	could
apercevoir	see
fouiller	search
accueillir	welcome
envoyés	sent
marqua	marked
pause	break
rappela	reminded
surveiller	monitor
postés	posted
entrée	entry
domaine	domain
continua	continued
resteront	will
conscient	aware
rigoureusement	strictly
interdit	prohibited
quitter	leave
préalable	prior
laissent	leave
abuser	abuse
déguisements	costumes
ruses	tricks
quelconques	any
capes	capes
d'invisibilité	invisibility
amusé	amused
nature	nature
considération	consideration
excuses	apologies
sollicitations	solicitations
conseille	advises
donc	so
chacune	each
d'entre	of
l'occasion	the opportunity
m'adresse	me address
préfets	prefects
notre	our
préfet-en-chef	prefect-in-chief
homologue	counterpart
féminin	female
veillent	ensure
qu'aucun	no
élève	student
l'initiative	the initiative
contrarier	upset
mètres	meters
bomba	bomba
torse	torso
impressionnant	awesome
s'interrompit	if interrupted
extrême	extreme
attablés	seated
régnait	reigned
total	total
vint	came
troubler	disturb
continuer	continue
note	note
joyeuse	joyful
reprit-il	"he said
heureux	happy
d'accueillir	welcome
d'abord	first
charger	load
applaudissements	applause
tièdes	warm
seuls	only
ceux	those
trouvés	found
applaudirent	cheered
cœur	heart
collègues	colleagues
belles	beautiful
robes	dresses
singulièrement	singularly
miteux	shabby
regarde	look at
rogue	rogue
souffla	blew
l'oreille	the ear
enseignait	taught
l'art	the art
potions	potions
fixement	staring
notoriété	awareness
publique	public
briguait	preparing to stand
détestait	hated
l'expression	the expression
dégoût	disgust
déformait	deformed
traits	features
maigre	lean
cireux	waxy
expression	expression
réservait	reserved
croisait	crossed
quant	as
nomination	appointment
évanouis	faded
informer	inform
brûlopot	brûlopot
soins	care
retraite	retirement
afin	in order
s'occuper	care
longuement	long
derniers	last
membres	members
restaient	remained
ravi	ravi
annoncer	announce
discipline	discipline
désormais	now
enseignée	taught
rubeus	redglow
accepté	accepted
d'ajouter	add
responsabilité	responsibility
fonctions	functions
garde-chasse	gamekeeper
stupéfait	stunned
enthousiasme	enthusiasm
tumultueux	tumultuous
accueillirent	welcomed
particulier	particular
pencha	bent
teint	complexion
écarlate	scarlet
baissés	lowered
énormes	huge
large	wide
dissimulait	hid
hirsute	shaggy
douter	doubt
frappant	striking
acheter	buy
livre	book
mord	bites
remarquèrent	noticed
s'essuyait	wiped her
nappe	tablecloth
l'essentiel	the essential
conclut	concludes
commence	begins
assiettes	plates
gobelets	cups
alignés	aligned
remplirent	filled
mets	mets
affamé	hungry
servit	served
abondance	abundance
portée	scope
gloutonnement	gloutonnement
délectable	delectable
résonnait	sounded
conversations	conversations
rires	laughter
auxquels	which
mêlait	mixed
cliquetis	rattling
couverts	covered
hâte	looking forward
fête	feast
savaient	knew
signifiait	meant
diplômes	diplomas
renvoyé	returned
troisième	third
d'études	studies
faute	fault
commise	committed
c'étaient	it was
définitivement	definitely
établi	established
innocence	innocence
l'année	the year
précédente	previous
tarte	pie
citrouille	pumpkin
plats	dishes
or	gold
coucher	bedroom
profitèrent	took advantage of the situation
précipiter	rush
bravo	bravo
s'écria	cried
arrivant	arriving
luisant	shiny
l'aide	using
serviette	towel
n'arrive	arrives
croire	believe
dès	as soon
déclaré	said
assez	enough
rêvé	dreamed
submergé	submerged
l'émotion	the emotion
enfouit	buried
partir	from
rejoignirent	joined
flot	stream
gravirent	rushed up
s'engouffrèrent	if engouffrèrent
dédale	maze
couloirs	corridors
d'escaliers	stairs
secrète	secret
portrait	portrait
grosse	big
femme	woman
vêtue	dressed
rosé	rosé
j'arrive	I can
fortuna	fortuna
major	major
tristesse	sadness
n'arrivait	there was
souvenir	remember
mots	words
franchirent	crossed
simple	simple
trou	hole
permettait	allowed
d'accéder	access
commune	common
filles	girls
garçons	boys
montèrent	went up
escaliers	stairs
dortoirs	dormitories
respectifs	respective
escalada	escalada
joie	joy
d'être	to be
retour	return
pénétrèrent	penetrated
dortoir	dormitory
familier	familiar
ronde	round
remplie	filled
lits	beds
baldaquin	canopy
satisfait	satisfied
