10	10
la	the
carte	card
du	the
maraudeur	marauder
madame	mrs.
pomfresh	pomfresh
insista	insisted
pour	for
garder	keep
harry	harry
à	to
l'infirmerie	the infirmary
jusqu'à	up to
fin	end
week-end	weekend
il	it
ne	do
chercha	sought
pas	not
discuter	discuss
ni	or
se	is
plaindre	complain
mais	but
refusa	refused
qu'elle	it
jette	throws
les	the
débris	debris
de	of
son	its
nimbus	nimbus
2000	2000
savait	knew
que	that
c'était	it was
idiot	idiot
qu'il	it
était	was
impossible	impossible
réparer	repair
le	the
balai	broom
ainsi	as well
avait	had
l'impression	printing
d'avoir	to have
perdu	lost
l'un	one
ses	its
meilleurs	best
amis	friends
reçut	received
un	a
flot	stream
visiteurs	visitors
chacun	each
cherchant	seeking
lui	him
remonter	back
moral	moral
hagrid	hagrid
envoya	sent
bouquet	bouquet
fleurs	flowers
qui	that
ressemblaient	looked like
des	of
choux	cabbage
jaunes	yellow
et	and
étaient	were
infestées	infested
perce-	snowdrops
oreilles	ears
ginny	ginny
weasley	weasley
joues	cheeks
écarlates	scarlet
arriva	came to pass
avec	with
une	a
vœux	best wishes
fabriquée	manufactured
elle-même	itself
cessait	stopped
chanter	sing
d'une	a
voix	voice
criarde	the garish
seul	only
moyen	average
faire	do
taire	shut up
coincer	stuck
sous	under
coupe	cup
fruits	fruit
l'équipe	the team
gryffondor	gryffindor
revint	returned
voir	see
dimanche	Sunday
matin	morning
cette	this
fois	time
dubois	dubois
là	there
dit	said
d'outre-tombe	from beyond the grave
en	in
voulait	wanted
moins	less
monde	world
ron	ron
hermione	hermione
quittèrent	left
chevet	bedside
soir	evening
pourtant	yet
aucune	no
parole	word
réconfort	comfort
parvint	managed
consoler	comfort
car	because
savoir	know
ce	this
troublait	confused
véritablement	truly
n'avait	had
parlé	spoken
personne	person
sinistros	sinistros
même	even
serait	would be
pris	taken
panique	panic
qu'hermione	as hermione
moquerait	laugh
n'en	do
restait	remained
apparu	appeared
deux	two
ces	these
apparitions	appearances
avaient	had
été	been
suivies	followed
d'accidents	accidents
failli	bankrupt
tuer	kill
première	first
manqué	missed
passer	pass
roues	wheels
magicobus	magicobus
deuxième	second
fait	fact
chute	fall
quinze	fifteen
mètres	meters
allait-il	was he going to
continuer	continue
narguer	taunt
meure	die
vraiment	really
reste	rest
sa	its
vie	life
regarder	watch
par-dessus	above
épaule	shoulder
hantise	haunting
surgir	arise
bête	beast
puis	then
y	there
détraqueurs	détraqueurs
a	has
chaque	each
pensait	thought
sentait	felt
malade	sick
humilié	humiliated
tout	all
s'accordait	the general consensus was
dire	say
épouvantables	terrible
d'autre	on the other
s'évanouissait	disappeared
quand	when
d'eux	of them
s'approchait	approaching
n'entendait	did
dans	in
tête	head
cris	cree
parents	parents
l'agonie	the agony
bien	well
présent	this
appartenait	belonged
suppliante	suppliant
cessé	stopped
répéter	repeat
paroles	lyrics
pendant	during
longues	long
heures	hours
passées	past
sans	without
dormir	sleep
allongé	lying
au	the
cœur	heart
nuit	night
yeux	eyes
fixés	set
sur	on
traits	features
lumière	light
clair	clear
lune	moon
projetait	projected
plafond	ceiling
lorsque	when
s'étaient	had
approchés	approached
entendu	heard
derniers	last
mots	words
mère	mother
prononcés	pronounced
avant	before
mourir	die
dernière	last
tentative	attempt
protéger	protect
lord	lord
voldemort	voldemort
aussi	also
rire	laugh
tue	kills
somnolait	was dozing
parfois	sometimes
plongeant	plunging
rêves	dreams
peuplés	populated
mains	hands
putréfiées	rotten
silhouettes	silhouettes
implorantes	supplicant
immobiles	still
comme	as
statues	statues
réveillait	woke up
sursaut	startle
lundi	Monday
fut	was
soulagement	relief
retrouver	find
l'agitation	the hustle and bustle
bruit	noise
l'école	the school
l'obligeaient	the forced
penser	think
autre	other
chose	thing
s'il	if it
devait	should
subir	undergo
railleries	taunts
drago	drago
malefoy	malfoy
défaite	defeat
rendu	rendering
fou	crazy
bonheur	happiness
fini	finished
par	by
enlever	remove
bandages	bandages
profitait	enjoying
l'usage	the use
retrouvé	found
bras	arm
imiter	imitate
tombant	falling
consacra	dedicated
bonne	good
partie	part
cours	during
potions	potions
mimer	mimic
bout	end
d'un	a
moment	time
n'y	there
tint	tint
plus	more
jeta	threw
figure	figure
gros	wholesale
crocodile	crocodile
gluant	sticky
amena	brought
rogue	rogue
cinquante	fifty
points	points
si	if
jamais	never
c'est	it is
encore	yet
nous	we
défense	defence
contre	against
forces	forces
mal	evil
je	I
me	me
fais	do
porter	wear
tandis	while
qu'ils	they
rendaient	made
classe	class
lupin	lupin
après	after
déjeuner	breakfast
regarde	look at
est	is
l'intérieur	inside
coup	blow
d'œil	eye
derrière	behind
porte	door
Ça	It
va	will
dit-elle	she said
professeur	professor
retour	return
pouvait	could
aucun	no
doute	doubt
vieille	old
robe	dress
sorcier	sorcerer
pendait	hung
épaules	shoulders
grands	great
cernes	dark circles
noirs	black
adressa	addressed
cependant	however
sourire	smile
aux	the
élèves	students
s'installèrent	settled
explosèrent	exploded
aussitôt	as soon
récriminations	recriminations
plaignant	complainant
conduite	conduct
l'absence	the absence
n'est	there is
juste	just
faisait	was
simple	simple
remplacement	replacement
pourquoi	why
a-t-il	there
donné	given
devoir	duty
on	it
sait	knows
rien	nothing
loups-garous	werewolves
rouleaux	rolls
parchemin	parchment
avez-vous	have you
n'avions	did
étudié	studied
chapitre	chapter
demanda	asked
sourcils	eyebrows
légèrement	slightly
froncés	a frown
brouhaha	hubbub
reprit	took
belle	beautiful
oui	yes
qu'on	we
très	very
retard	delay
écoutait	listened to
sourit	smiles
voyant	light
visages	faces
indignés	indignant
vous	you
inquiétez	worry
parlerai	talk about
n'aurez	will not
besoin	need
oh	oh
non	not
déçue	disappointed
l'avais	had
déjà	already
terminé	finished
passionnant	exciting
apporté	brought
cage	cage
verre	glass
contenait	contained
pitiponk	pitiponk
petite	small
créature	creature
apparemment	apparently
frêle	frail
inoffensive	harmless
dotée	with
seule	only
patte	paw
dont	which
corps	body
semblaient	seemed to
constitués	made
filets	nets
fumée	smoke
entrelacés	interlaced
attire	attracts
voyageurs	travelers
vers	to
sols	soil
marécageux	marshy
expliqua	explained
remarqué	noticed
lanterne	lantern
tient	holds
main	hand
sautille	hops
gens	people
suivent	follow
émit	issued
horrible	horrible
succion	sucking
paroi	wall
cloche	bell
retentit	sounds
ramassa	picked up
affaires	business
dirigea	led
sortie	output
instant	now
alors	then
j'ai	I
quelque	some
fit	fit
volte-face	volte-face
s'approcha	approached
recouvrait	covered
morceau	song
d'étoffe	fabric
parler	talk
match	match
poursuivit	continued
rangeant	ranking
livres	books
cartable	satchel
navré	sorry
d'apprendre	to learn
destruction	destruction
votre	your
répondit	replied
saule	willow
l'a	the
cassé	broken
mille	thousand
morceaux	pieces
soupira	sighed
ils	they
ont	have
planté	planted
cogneur	slugger
l'année	the year
mon	my
arrivée	arrival
poudlard	hogwarts
l'époque	the time
grand	great
jeu	game
consistait	was
essayer	try
s'en	in
approcher	approach
suffisamment	enough
toucher	touch
tronc	trunk
garçon	boy
nom	name
dave	dave
goujon	stud
perdre	lose
œil	eye
n'avons	have
eu	had
droit	right
chance	chance
tirer	shoot
indemne	free
raconté	told
s'est	is
passé	past
décider	decide
poser	ask
question	question
crois	believe
vu	seen
dumbledore	dumbledore
colère	anger
tenir	take
place	place
sont	are
furieux	furious
leur	their
refuse	refuses
l'entrée	the entry
l'enceinte	the speaker
j'imagine	I guess
cause	cause
êtes	are
tombé	fallen
hésita	hesitated
franchit	crosses
lèvres	lips
presque	almost
malgré	despite
est-ce	is this
font	do
cet	this
effet-là	effect
suis	am
n'a	did
quelconque	any
faiblesse	weakness
lu	read
pensées	thoughts
affectent	affect
n'importe	any
parce	because
horreurs	horrors
n'existent	does not exist
chez	in
autres	other
rayon	radius
soleil	sun
hivernal	winter
traversa	crossed
salle	room
éclairant	illuminating
cheveux	hair
gris	grey
rides	wrinkles
creusaient	digging
visage	face
jeune	young
comptent	count
parmi	among
répugnantes	disgusting
créatures	creatures
puisse	can
trouver	find
surface	surface
terre	earth
infestent	infest
lieux	places
sombres	dark
immondes	filthy
jouissent	enjoy
pourriture	rot
désespoir	despair
vident	empty
toute	any
paix	peace
espoir	hope
l'air	the air
entoure	surrounds
moldus	muggle
sentent	feel
présence	presence
puissent	can
s'approche	approach
trop	too
près	near
détraqueur	détraqueur
sensation	sensation
plaisir	fun
souvenir	remember
heureux	happy
disparaissent	disappear
donne	gives
temps	time
nourrit	feeds
réduire	reduce
ressemble	looks like
–	-
êtres	beings
maléfiques	evil
dépourvus	free
d'âme	soul
celui	the
subit	undergoes
pouvoir	power
garde	guard
mémoire	memory
pires	the worst
moments	moments
suffiraient	suffice
tomber	fall
honte	shame
ça	it
moi	me
s'interrompit	if interrupted
regard	look
fixé	set
bureau	office
j'entends	I hear
ma	my
acheva-t-il	completed-t-he
gorge	throat
serrée	tight
amorça	started
mouvement	movement
prendre	take
l'épaule	the shoulder
ravisa	thought better of it
eut	had
silence	silence
sont-ils	are they
entrés	entered
enfin	finally
ton	your
amer	bitter
commencent	begin
avoir	have
faim	hunger
fermant	closing
laisser	let
pénétrer	enter
n'ont	have
proie	prey
humaine	human
pense	think
pu	could
résister	resist
foule	crowd
rassemblée	collected
stade	stage
excitation	excitement
émotions	emotions
exacerbées	exacerbated
l'idée	the idea
festin	feast
azkaban	azkaban
doit	must
être	be
endroit	place
murmura	whispered
mine	mine
sombre	dark
approuva	approved
signe	sign
forteresse	fortress
située	located
minuscule	tiny
îlot	island
large	wide
côtes	coast
mur	wall
ou	or
d'eau	water
prisonniers	prisoners
enfermés	locked
propre	own
incapables	unable
moindre	less
pensée	thought
agréable	nice
plupart	most
d'entre	of
eux	them
deviennent	become
fous	crazy
quelques	a few
semaines	weeks
sirius	sirius
black	black
réussi	successful
échapper	escape
lentement	slowly
glissa	slipped
tomba	fell
baissa	lowered
ramasser	pick up
dit-il	he said
relevant	under
dû	due
combattre	fight
croyais	thought
possible	possible
normalement	normally
sorciers	wizards
leurs	their
pouvoirs	powers
lorsqu'on	when
laisse	leaves
longtemps	for a long time
train	train
avez	have
partir	from
soudain	suddenly
existe	there is
certains	some
moyens	means
peut	can
servir	serve
qu'un	a
compartiment	compartment
nombreux	many
difficile	difficult
quels	what
pourriez	could
apprendre	learn
spécialité	specialty
contraire	contrary
s'ils	if they
reviennent	return
prochain	next
faut	must
défende	defend
regarda	looked at
exprimait	expressed
détermination	determination
farouche	fierce
sembla	seemed
hésiter	hesitation
bon	good
vais	'll
aider	help
faudra	will
attendre	wait
trimestre	quarter
beaucoup	a lot
choses	things
vacances	holiday
choisi	chosen
mauvais	bad
retrouva	found
vite	fast
excellent	excellent
d'abord	first
promesse	promise
donner	give
leçons	lessons
espérer	hope
n'entendrait	hear
hurlements	howling
déchirants	the heart-rending
mort	death
ensuite	then
victoire	victory
écrasante	overwhelming
serdaigle	ravenclaw
celle	the
poufsouffle	hufflepuff
mois	months
novembre	November
laissait	left
remporter	win
énergie	energy
travailler	work
équipe	team
d'acharnement	hard work
pluie	rain
glacée	ice
continua	continued
début	beginning
décembre	December
vit	lives
l'ombre	the shadow
fureur	fury
maintenus	maintained
poste	post
entrées	entries
clarté	clarity
blanc	white
d'opale	opal
dissipa	cleared
l'obscurité	the dark
ciel	sky
beau	beautiful
sol	soil
boueux	muddy
couvrit	covered
givre	frost
étincelant	sparkling
l'atmosphère	the atmosphere
régnait	reigned
château	castle
annonçait	announced
noël	christmas
flitwick	flitwick
enseignait	taught
sortilèges	spells
décoré	decorated
petites	small
fées	fairy
scintillantes	sparkling
chandelles	candles
parlaient	spoke
air	air
ravi	ravi
projets	projects
décidé	decided
rester	stay
prétendait	claimed
supporterait	bear
compagnie	company
percy	percy
affirmait	said
absolument	absolutely
aller	go
bibliothèque	library
période	period
qu'en	in
réalité	reality
voulaient	wanted
extrêmement	extremely
reconnaissant	recognizing
grande	great
joie	joy
sauf	except
visite	visit
pré-au-lard	pre-to-bacon
prévue	provided
dernier	last
acheter	buy
tous	all
nos	our
cadeaux	gifts
là-bas	there
mes	my
seront	will be
enchantés	enchanted
envoie	sends
fils	son
dentaires	dental
menthe	mint
honeydukes	honeydukes
d'hermione	of hermione
dentistes	dentists
résigné	resigned
élève	student
troisième	third
année	year
participerait	participate
emprunta	borrowed
exemplaire	copy
quel	what
choisir	choose
décida	decided
journée	day
renseigner	learn
différents	different
modèles	models
disponibles	available
lors	when
séances	sessions
d'entraînement	training
s'était	had
servi	served
balais	brushes
Étoile	Star
filante	shooting
manquait	missing
puissance	power
stabilité	stability
fallait	had to
prix	price
nouveau	new
mesure	measurement
talents	talent
samedi	Saturday
jour	day
revoir	review
emmitouflés	bundled up
capes	capes
écharpes	scarves
retourna	returned
tour	tour
au-	at-
dehors	outside
neige	snow
commencé	started
plongé	immersed
hé	hey
trouvait	was
couloir	hallway
étage	floor
fred	fred
george	george
venaient	came
d'apparaître	to appear
statue	statue
sorcière	witch
borgne	one-eyed
bossue	hunchback
qu'est-ce	what is this
faites	do
s'étonna	was surprised
comment	how
n'êtes	there are
partis	parties
te	te
d'amusant	fun
d'y	there
clin	clin
d'oeil	eye
mystérieux	mysterious
viens	just
montra	showed
vide	empty
gauche	left
suivit	followed
referma	closed
tourna	turned
rayonnant	radiant
cadeau	gift
toi	you
peu	little
d'avance	advance
geste	gesture
majestueux	majestic
tira	drew
cape	cape
posa	posa
table	table
carré	square
abîmé	damaged
portait	wore
inscription	registration
soupçonnait	suspected
farces	pranks
secret	secret
l'objet	the object
perplexe	puzzled
quoi	what
demanda-t-il	he asked
ceci	this
tapotant	tapping
notre	our
succès	success
séparer	separate
ajouta	added
tu	you
avais	had
façon	how
connaît	knows
léguer	bequeath
sert	serves
grand-chose	much
maintenant	now
m'être	me be
utile	useful
vieux	old
s'exclama	exclaimed
grimace	grin
venait	came
l'offenser	the offending
gravement	seriously
explique-lui	explain
eh	eh
voilà	this is
étions	were
jeunes	young
insouciants	carefree
innocents	innocent
petit	small
n'imaginait	never imagined
aient	have
disons	let's say
qu'aujourd'hui	today
avons	have
ennui	boredom
rusard	rusard
exploser	explode
bombabouse	bombabouse
raison	reason
mystérieuse	mysterious
plu	plu
traînés	dragged
menacés	threatened
l'habituelle	the usual
retenue	withholding
éventration	incisional hernia
tiroir	drawer
armoire	wardrobe
rangement	storage
écrit	written
objets	objects
dangereux	dangerous
confisqués	confiscated
dis	say
lança	launched
aurais	would have
détourné	hijacked
attention	attention
laissant	leaving
ouvert	open
attraper	catch
ait	has
su	su
probablement	probably
douté	doubted
sinon	otherwise
l'aurait	would have
confisqué	confiscated
savez	know
marche	walking
goguenard	bantering
merveille	wonder
appris	learned
professeurs	teachers
réunis	together
essayez	try
marcher	walk
regardant	looking at
râpé	grated
répliqua	replied
sortit	went out
baguette	wand
magique	magic
effleura	hit
récitant	reciting
jure	swear
solennellement	solemnly
intentions	intentions
mauvaises	bad
petits	small
d'encre	ink
répandirent	spread
dessinant	drawing
toile	canvas
d'araignée	spider
joignirent	joined
croisèrent	crossed
s'étendirent	spread
quatre	four
coins	corners
tracés	paths
écriture	writing
ronde	round
l'encre	the ink
verte	green
apparurent	appeared
haut	top
document	document
messieurs	gentlemen
lunard	lunard
queudver	queudver
patmol	patmol
cornedrue	cornedrue
spécialistes	specialists
assistance	assistance
maniganceurs	maniganceurs
coups	shots
fiers	proud
présenter	present
représentait	represented
plan	plan
détaillé	detailed
parc	park
environnant	surrounding
remarquable	remarkable
c'étaient	it was
minuscules	tiny
voyait	saw
bouger	move
ici	here
accompagné	accompanied
lettres	letters
Ébahi	Wow!
pencha	bent
point	point
situé	located
coin	corner
supérieur	higher
indiquait	indicated
cent	cent
miss	miss
teigne	ringworm
chatte	pussy
concierge	concierge
rôdait	was prowling
premier	first
peeves	peeves
l'esprit	the spirit
frappeur	batting
cabriolait	cabriolait
trophées	trophies
remarqua	noticed
montrait	showed
plusieurs	several
passages	passages
secrets	secrets
connaissait	knew
menaient	led
suivant	following
l'index	the index
sept	seven
quatre-là	four
sûrs	safe
d'être	to be
seuls	only
connaître	know
ceux-ci	these
t'occupe	never mind
trouve	find
miroir	mirror
quatrième	fourth
emprunté	borrowed
l'hiver	the winter
éboulement	landslide
devenu	now
impraticable	impractical
celui-là	this one
l'utiliser	the use
dessus	top
celui-ci	it
mène	leads
cave	cellar
souvent	often
remarqueras	notice
l'endroit	the place
précis	specific
où	where
devons	must
hommes	men
pleins	full
noblesse	nobility
travaillé	worked
compter	from
nouvelle	new
génération	generation
violer	violate
règlements	regulations
solennel	solemn
exact	exact
n'oublie	do not forget
d'effacer	delete
usage	use
pourra	may
lire	read
avertit	warns
suffit	just
prononçant	speaking
formule	formula
méfait	mischief
accompli	accomplished
redeviendra	return
vierge	virgin
l'heure	the time
satisfait	satisfied
resta	remained
contempler	contemplate
miraculeuse	miraculous
tourner	turn
renifler	sniff
passage	passage
pourrait	could
sortir	out
devant	before
phrase	sentence
prononcée	pronounced
mr	mr
fie	fie
capable	able
d'agir	to act
dépenser	spend
vois	see
cerveau	brain
précisément	precisely
magiques	magic
lesquels	which
prononcé	pronounced
mise	update
qu'après	after
utiliser	use
simplement	simply
voler	fly
quelqu'un	someone
d'ailleurs	moreover,
servis	served
années	years
arrive	happens
fâcheux	unfortunate
doigt	finger
menait	led
brusquement	suddenly
obéissait	obeyed
ordre	order
impérieux	compelling
roula	roula
fourra	stuffed
poche	pocket
entrouvrit	entrouvrit
centimètres	centimeters
désert	desert
précaution	caution
quitta	left
fallait-il	was it
ressortit	came out of it
s'aperçut	saw
surprise	surprise
figurait	was
potter	potter
exactement	exactly
véritable	true
arrêté	stopped
milieu	middle
observant	observing
attentivement	carefully
image	image
tapotait	tapotait
saisit	captures
vraie	true
tapota	tapped
produisit	produced
consulta	consulta
bulle	bubble
bande	band
dessinée	comic
apparut	appeared
côté	side
mot	word
dissendium	dissendium
donnant	giving
bosse	kicker
latéralement	laterally
dégageant	releasing
espace	space
suffisant	sufficient
permettre	allow
plutôt	rather
mince	thin
rangea	sided
plongea	dove
l'ouverture	the opening
longuement	long
sorte	so
toboggan	slide
pierre	stone
atterrit	lands
froid	cold
humide	wet
releva	rose
obscurité	darkness
totale	total
marmonna	muttered
lumos	lumos
rai	rai
éclaira	lit
étroit	close
bas	the bottom
creusé	dug
l'extrémité	the end
murmurant	muttering
instantanément	instantly
redevint	once again
plia	folded
soigneusement	carefully
avança	advanced
battant	flying
mélange	mix
d'excitation	excitation
d'appréhension	apprehension
décrivait	described
courbes	curves
incessantes	incessant
terrier	terrier
lapin	rabbit
géant	giant
éclairer	light
voie	way
trébuchant	stumbling
inégal	uneven
heure	time
remonta	came up
pente	slope
douce	soft
souffle	breath
court	short
hâta	haste
brûlantes	hot
pieds	feet
glacés	icy
dix	ten
minutes	minutes
tard	later
pied	foot
vieil	old
escalier	staircase
marches	steps
usées	waste
s'élevait	was
monta	went up
compta	accounting
cents	cents
cessa	ceased
heurta	hit
dur	hard
s'agissait	was
trappe	hatch
immobile	still
masser	massage
crâne	skull
l'oreille	the ear
aguets	watch
silencieux	silent
au-dessus	above
poussa	pushed
remplie	filled
caisses	crates
cageots	crates
hissa	hissa
travers	through
elle	it
fondait	based
parfaitement	perfectly
poussière	dust
remarquer	notice
s'avança	advanced
l'escalier	the stairs
bois	wood
rez-de-chaussée	ground floor
entendait	heard
clochette	bell
s'ouvrit	opened
proche	close
s'apprêtait	was about
descendre	down
rapporte-moi	bring me
boîte	box
gommes	gums
limaces	slugs
chéri	darling
femme	woman
descendirent	went down
précipita	rushed
énorme	huge
caisse	fund
attendit	waited
déplaçait	moved
boîtes	boxes
carton	carton
d'en	to
face	in the face of
rapide	fast
cachette	cache
jetant	throwing
dos	back
homme	man
massif	massive
chauve	bald
luisante	shiny
fond	background
l'entrebâillement	round
comptoir	counter
courbé	curved
l'autre	the other
redressa	straightened
n'était	there was
tant	as
d'élèves	students
boutique	shop
faufila	stalked
étouffa	choked
imaginant	imagining
ferait	would
dudley	dudley
d'innombrables	countless
étagères	shelves
débordaient	outside
succulentes	succulent
friandises	treats
imaginer	imagine
nougats	nougat
moelleux	fluffy
cubes	cubes
glace	ice
noix	nuts
coco	coco
caramels	caramel
dorés	golden
centaines	hundreds
chocolats	chocolates
disposés	willing
rangées	rows
nettes	net
tonneau	barrel
rempli	filled
dragées	dragees
surprises	surprises
bertie	bertie
crochue	crooked
fizwizbiz	fizwizbiz
fameux	famous
sorbets	sorbets
permettent	allow
s'élever	rise
bonbons	candy
effets	effects
spéciaux	special
bulles	bubbles
baveuses	drooling
(un	(a
chewing-gum	chewing gum
produisant	producing
mauves	purple
éclater	burst
jours)	days)
d'étranges	strange
déposaient	filed
sucre	sugar
entre	between
dents	teeth
gnomes	gnomes
poivre	pepper
(	(
crachez	spit
feu	fire
vos	your
)	)
souris	mouse
glacées	ice
entendrez	hear
couiner	the whining
pâtes	pasta
forme	form
crapauds	toads
sentirez	feel
sauter	jump
estomac	stomach
délicates	delicate
plumes	feathers
explosifs	explosives
mêla	mingled with
groupe	group
sixième	sixth
pancarte	sign
goûts	tastes
bizarres	weird
au-dessous	below
s'intéressaient	if interested
panier	basket
sucettes	lollipops
parfumées	scented
sang	blood
beurk	yuck
n'aimera	will not
vampires	vampires
disait	said
mettant	putting
bocal	jar
nids	nests
cafards	cockroaches
nez	nose
sûrement	surely
faillit	almost
lâcher	letting go
aiguë	acute
as-tu	have you
ben	ben
donc	so
s'écria	cried
admiratif	admiring
as	as
transplaner	transplaner
sûr	course
l'entendre	hear
raconta	told
l'histoire	the story
l'aient	have
donnée	given
scandalisé	scandalized
frère	brother
assura	assura
paraissait	seemed
ridicule	ridiculous
mcgonagall	mcgonagall
n'est-ce	is this
certainement	certainly
es	es
folle	crazy
lançant	launching
effaré	aghast
priver	deprive
d'aussi	as
formidable	great
donnais	gave
faudrait	should
dise	say
procurer	buy
comprendrait	would
suite	suite
l'ont	have
volée	fly
chuchota	whispered
indiqués	listed
soient	are
courant	current
précipitamment	hurriedly
tunnels	tunnels
d'accord	agreement
d'après	after
aboutit	results
découvrir	discover
avis	notice
apposé	affixed
magasin	store
ministÈre	department
magie	magic
rappelé	recalled
aimable	kind
clientèle	customer
nouvel	new
patrouilleront	will patrol
rues	streets
toutes	all
nuits	nights
coucher	bedroom
prise	outlet
l'intérêt	the interest
population	population
restera	will
vigueur	force
capture	capture
conséquence	result
recommandons	recommend
terminer	finish
achats	purchases
tombée	fallen
joyeux	happy
basse	low
j'aimerais	I would like to
d'entrer	to enter
pleines	full
patrons	bosses
l'entendraient	would hear
essayait	tried
s'introduire	enter
pleine	full
habitent	live
visiblement	obviously
efforts	efforts
possibles	possible
objection	objection
devrait	should
venir	come
d'autorisation	authorization
signée	signed
aperçoit	see
sera	will be
ennuis	trouble
jusqu'au	until the
cou	neck
passerait	would
apparaissait	appeared
aurait	would
là-dedans	there
montrant	showing
tourbillons	swirls
épaisse	thick
tombaient	fell
au-dehors	outside
s'amuser	have fun
contrariée	upset
mordit	bit
lèvre	lip
vas	vas
dénoncer	denounce
l'emmenant	the taking
suçacides	suçacides
m'en	me
j'avais	I had
ans	years
m'a	me
trou	hole
langue	language
souviens	remember
maman	mom
contempla	stared at
songeur	pensive
mangerait	eat
disais	said
cacahuètes	peanuts
eurent	had
choix	choice
payé	paid
trois	three
sortirent	went out
retrouvèrent	found
blizzard	blizzard
continuait	continued
souffler	blow
postale	postal
cottages	cottages
boutiques	shops
recouverts	covered
couche	layer
fraîche	fresh
couronnes	crowns
houx	holly
accrochées	hung
portes	doors
guirlandes	garlands
pendaient	hung
branches	branches
arbres	trees
frissonna	shivered
contrairement	unlike
remontèrent	went
rue	street
penchés	looked
vent	wind
criant	screaming
écharpe	scarf
zonko	zonko
indiqua	said
cabane	hut
hurlante	howling
dirais	would say
d'aller	go
boire	drink
bièraubeurre	bièraubeurre
proposa	proposed
claquant	slamming
gelées	frozen
trouva	found
excellente	excellent
traversèrent	crossed
pénétrèrent	penetrated
auberge	hostel
bondé	crowded
bruyant	noisy
chaleureux	warm
enfumé	smoky
jolie	pretty
généreuses	generous
servait	served
braillards	noisy
accoudés	leaning
bar	bar
rosmerta	rosmerta
chercher	search
chopes	mugs
ajouta-t-il	he added
rougissant	blushing
s'avancèrent	advanced
trouvèrent	found
libre	free
fenêtre	window
splendide	splendid
sapin	fir
dressé	upright
cheminée	fireplace
cinq	five
chaude	hot
levant	rising
chope	mug
but	purpose
longue	long
gorgée	sip
délicieuse	delicious
eût	had
goûtée	a taste of
réchauffer	warm up
bref	brief
ébouriffa	ruffled
s'ouvrir	open
bord	edge
nouveaux	new
arrivants	arrivals
s'étrangler	strangle
tourbillon	whirlpool
firent	did
entrée	entry
l'auberge	the hostel
suivis	followed
conversation	conversation
trapu	stout
coiffé	wearing
chapeau	hat
melon	melon
vert	green
vêtu	dressed
rayures	stripes
cornélius	cornelius
fudge	fudge
ministre	minister
éclair	flash
posèrent	laid
appuyèrent	supported
vigoureusement	vigorously
forcer	force
s'accroupir	crouch
dégoulinant	dripping
hors	out
vue	view
venus	come
s'avancer	advance
s'arrêter	stop
repartir	leave
direction	management
entendit	heard
murmurer	whisper
mobiliarbus	mobiliarbus
s'éleva	rose
déplaça	moved
retomba	fell
dissimulant	concealing
regards	looks
basses	low
chaises	chairs
s'écarter	depart
voisine	nearby
s'asseoir	sit
grognements	grunts
satisfaction	satisfaction
distingua	distinguished
chaussures	shoes
hauts	senior
talons	heels
s'avançaient	advanced
jus	juice
d'oeillet	grommet
pintes	pints
d'hydromel	mead
épices	spices
sirop	syrup
cerise	cherry
soda	soda
boule	ball
ombrelle	umbrella
miam	yum
claquement	banging
rhum	rum
groseille	gooseberry
monsieur	mr.
merci	thank you
chère	dear
prendrez	take
asseyez-vous	sit
s'éloigner	away
revenir	return
battre	beat
douloureusement	painfully
poitrine	chest
avait-il	had he
oublier	forget
combien	how
allaient-ils	were they going to
assis	sitting
glisser	drag
amène	leads
pivoter	rotate
chaise	chair
regardait	watched
autour	around
vérifier	check
interlocuteurs	interlocutors
halloween	halloween
j'en	I
ai	I
vaguement	vaguely
reconnut	recognized
exaspéré	enraged
pensez	think
toujours	always
certain	some
brièvement	briefly
fouillé	searched
agacée	nettled
clients	customers
terrifiés	terrified
commerce	trade
n'aime	likes
gêné	embarrassed
nécessaire	necessary
malheureux	unhappy
entrer	enter
sèchement	curtly
voulez-vous	do you want to
pareilles	such
couina	couina
touchaient	touched
n'oublions	let's not forget the
danger	danger
objecta	objected
savons	know
n'arrive	arrives
croire	believe
n'aurais	would have
imaginé	imagined
prendrait	would
parti	party
m'aviez	I had
moment-là	time
deviendrait	would
aujourd'hui	today
j'aurais	I would have
pensé	thought
aviez	had
bu	bu
connaissez	know
moitié	half
abrupt	steep
savent	know
pire	worst
excité	excited
curiosité	curiosity
d'assassiner	murder
effet	effect
souveniez	remember
rappelez	remember
meilleur	best
ami	friend
compte	account
faisaient	were
ah	ah
james	james
lâcha	released
sonore	sound
donna	donna
justement	precisely
chefs	heads
brillants	brilliant
exceptionnellement	exceptionally
vérité	truth
causé	caused
autant	as much
d'ennuis	trouble
deux-là	two
peuvent	can
également	also
prétendre	claim
titre	title
frères	brothers
intervint	intervened
inséparables	inseparable
confiance	trust
absolue	absolute
vrai	true
quitté	left
témoin	witness
mariage	marriage
lily	lily
parrain	sponsor
cela	this
imaginez	imagine
l'effet	the effect
associé	associated
vous-savez-qui	you-know-who
marmonnement	mumbling
peine	penalty
audible	audible
rares	rare
ceux	those
conscients	aware
cible	target
luttait	fought
relâche	releases
mage	mage
noir	black
disposait	had
nombre	number
d'espions	spies
fort	fort
utiles	useful
mis	put
immédiatement	immediately
averti	warned
conseillé	recommended
cacher	hide
doutez	doubt
recours	use
sortilège	hex
fidelitas	fidelitas
semblait	seemed
passionnée	passionate
s'éclaircit	clears up
complexité	complexity
s'agit	is
procédé	process
destiné	for
unique	single
l'information	information
dissimulée	concealed
choisie	chosen
appelle	calls
gardien	guardian
devient	becomes
décide	decides
divulguer	disclose
refusait	refused
fouiller	search
village	village
vivaient	lived
depuis	since
collé	stuck
salon	living room
affirmé	said
préféré	favorite
révéler	reveal
trouvaient	were
lui-même	himself
l'intention	the intention
inquiet	worried
l'avoir	have
proposer	offer
devenir	become
persuadé	persuaded
informait	informed
régulièrement	regularly
déplacements	travel
sombrement	darkly
trahissait	betrayed
fournissant	providing
renseignements	information
vous-savez-	you-know-
insisté	insisted
semaine	week
pratiqué	practiced
trahis	betrayed
lassé	tired
rôle	role
d'agent	agent
double	double
prêt	loan
déclarer	declare
ouvertement	openly
partisan	supporter
semble	seems
prévu	expected
nul	no
l'ignore	ignore
détruit	destroyed
privé	private
maléfique	evil
terriblement	terribly
affaibli	weakened
condamné	sentenced
disparaître	disappear
trouvé	found
situation	situation
désagréable	unpleasant
maître	master
tombait	fell
d'essayer	try
fuir	flee
misérable	miserable
traître	traitor
abject	abject
répugnant	disgusting
forte	strong
interrompirent	suspended
conversations	conversations
chut	shhh
l'ai	I
grogna	" 
dois	do
rencontré	met
allé	gone
maison	home
assassinat	assassination
tiré	shot
ruines	ruins
pauvre	poor
grosse	big
plaie	wound
front	front
morts	dead
apparaît	appears
moto	motorcycle
volante	flying
utilisait	used
déplacer	move
demandé	asked
j'ignorais	I didn't know
accouru	ran
rendre	make
pâle	pale
tremblant	tremblant
consolÉ	comforted
traÎtre	traitor
assassin	assassin
rugit	roars
prie	pray
protesta	protested
parlez	talk
pouvais-je	could I
bouleversait	upset
importait	importance
sort	fate
donne-moi	give me
m'occuperai	I will take care
seulement	only
reçu	received
instructions	instructions
répondu	answered
confié	entrusted
tante	aunt
oncle	uncle
essayé	tried
abandonner	abandon
proposé	proposed
emmener	take
aurai	will
m'a-t-il	I was there
douter	doubt
louche	ladle
aimait	loved
tellement	so
aurait-il	would it
facile	easy
repérer	identify
fuite	leak
nuit-là	night
ministère	department
trousses	kits
parie	bet
jeté	cast
mer	sea
passe	pass
long	long
récit	story
s'enfuir	escape
demanda-t-elle	he asked as she
certaine	some
attrapé	caught
lendemain	next day
avions	aircraft
amertume	bitterness
l'avons	have
peter	peter
pettigrow	pettigrow
chagrin	grief
sachant	knowing
lancé	launched
poursuite	further
grassouillet	chubby
traînait	dragged
culte	worship
niveau	level
m'est	I
arrivé	arrived
assez	enough
sévère	severe
regrette	regrets
enrhumée	cold
allons	will
minerva	minerva
n'ayez	don
remords	remorse
sympathie	sympathy
héros	hero
assisté	assisted
scène	scene
subi	suffered
d'amnésie	amnesia
d'autres	other
témoins	witnesses
coincé	stuck
sanglotait	sobbed
disant	saying
sorti	out
réduit	reduced
miettes	crumbs
moucha	blew her nose
douloureuse	painful
combats	fighting
duel	duel
garantis	guaranteed
serais	would be
embarrassé	embarrassed
l'aurais	would have
pièces	parts
nues	naked
dites	tell
bêtises	nonsense
brigade	brigade
d'élite	elite
tireurs	shooters
j'étais	I was
directeur	director
département	department
catastrophes	disasters
premiers	first
tuerie	slaughter
l'oublierai	forget
m'arrive	happens to me
rêver	dream
cratère	crater
profond	deep
canalisations	pipes
égouts	sewer
éclaté	burst
cadavres	corpses
jonchaient	littered
hurlaient	screaming
riait	laughed
éclats	shards
ensanglantée	bloody
fragments	fragments
personnes	people
moucher	blow
grave	serious
emmené	taken
vingt	twenty
l'ordre	the order
merlin	merlin
posthume	posthumous
représenté	represented
temps-là	time
enfermé	locked
laissa	let
soupir	sigh
est-il	is it
répondre	reply
l'est	the is
sens	meaning
commun	common
meurtre	murder
désespéré	desperate
cruel	cruel
inutile	useless
inspection	inspection
passent	pass
marmonner	mumble
dénuées	free
frappé	hit
constater	see
normal	normal
manière	way
raisonnable	reasonable
c'en	it
déconcertant	disconcerting
s'ennuyait	bored
calmement	calmly
journal	journal
voulais	wanted
regrettait	regretted
croisés	crusaders
stupéfait	stunned
d'effet	effect
mieux	better
gardés	kept
postés	posted
cellule	cell
dieu	god
essaye	try
rejoindre	join
vous-savez-qu	you-know-that
malheureusement	unfortunately
heu	uh
objectif	objective
final	final
évasif	evasive
espérons	hope
rattraper	catch up
parvienne	to reach
rendez-lui	visit
serviteur	servant
dévoué	dedicated
peur	fear
ressurgisse	ressurgisse
ténèbres	darkness
reposé	rested
devez	must
dîner	dinner
ferions	would
reprendre	resume
remettre	back
ondulèrent	ondulèrent
disparurent	disappeared
rouvrit	reopened
regardèrent	looked
prononcer	pronounce
