1	1
hibou	owl
express	express
a	has
bien	well
des	of
égards	ways
harry	harry
potter	potter
était	was
un	a
garçon	boy
plus	more
singuliers	singular
tout	all
d'abord	first
il	it
détestait	hated
les	the
vacances	holiday
d'été	summer
c'était	it was
la	the
période	period
de	of
l'année	the year
déplaisante	unpleasant
à	to
ses	its
yeux	eyes
ensuite	then
tenait	held
absolument	absolutely
faire	do
devoirs	duties
mais	but
obligé	forced
en	in
secret	secret
au	the
beau	beautiful
milieu	middle
nuit	night
enfin	finally
faut	must
également	also
signaler	report
que	that
sorcier	sorcerer
minuit	midnight
approchait	approaching
couvertures	blankets
tirées	from
par-dessus	above
sa	its
tête	head
comme	as
une	a
tente	tent
allongé	lying
plat	flat
ventre	belly
sur	on
son	its
lit	bed
lampe	lamp
torche	torch
dans	in
main	hand
livre	book
relié	connected
plein	full
cuir	leather
ouvert	open
oreiller	pillow
s'agissait	was
d'une	a
histoire	history
magie	magic
par	by
adalbert	adalbert
lasornette	lasornette
sourcils	eyebrows
froncés	a frown
fit	fit
courir	run
le	the
long	long
page	page
pointe	tip
plume	pen
d'aigle	eagle
qu'il	it
autre	other
cherchait	was looking for
idées	ideas
pour	for
dissertation	essay
sujet	about
suivant	following
crémation	cremation
sorcières	witches
xiv	xiv
e	e
siècle	century
totalement	totally
inefficace	ineffective
commentez	comment
et	and
discutez	discuss
s'arrêta	stopped
début	beginning
d'un	a
paragraphe	paragraph
qui	that
semblait	seemed
lui	him
convenir	agree
remonta	came up
nez	nose
lunettes	glasses
rondes	round
approcha	approached
du	the
lut	lut
ce	this
écrit	written
moyen	average
age	age
personnes	people
dépourvues	lacking
pouvoirs	powers
magiques	magic
(appelées	(called
communément	commonly
moldus	muggle
)	)
ressentaient	felt
terreur	terror
particulière	special
l'égard	respect
sorcellerie	witchcraft
étaient	were
souvent	often
incapables	unable
reconnaître	recognize
ceux	those
pratiquaient	practiced
vraiment	really
lorsque	when
extraordinaire	extraordinary
ou	or
sorcière	witch
doté	with
réels	real
capturé	captured
condamnation	conviction
bûcher	pyre
n'avait	had
aucun	no
effet	effect
condamné	sentenced
se	is
contentait	just
jeter	throw
simple	simple
sortilège	hex
gèle-flamme	freeze-flame
puis	then
faisait	was
semblant	pretend
tordre	twist
douleur	pain
l'apparente	the apparent
fournaise	furnace
alors	then
qu'en	in
réalité	reality
n'éprouvait	had
qu'une	a
agréable	nice
sensation	sensation
chatouillis	chatouillis
gwendoline	gwendoline
fantasque	whimsical
exemple	example
toujours	always
ravie	happy
brûler	burn
vive	cheers
tel	such
point	point
qu'elle	it
s'arrangea	arranged
être	be
capturée	captured
quarante-sept	forty-seven
fois	time
sous	under
divers	various
déguisements	costumes
tint	tint
entre	between
dents	teeth
glissa	slipped
l'oreiller	the pillow
prendre	take
bouteille	bottle
d'encre	ink
rouleau	roll
parchemin	parchment
avec	with
gestes	gestures
lents	slow
précautionneux	careful
dévissa	unscrewed
bouchon	cap
trempa	dipped
l'encre	the ink
mit	mit
écrire	write
s'arrêtant	stopping
temps	time
tendre	tender
l'oreille	the ear
car	because
si	if
l'un	one
membres	members
famille	family
dursley	dursley
rendait	made
salle	room
bains	bathroom
cet	this
instant	now
entendait	heard
passage	passage
grattement	scratching
avait	had
toutes	all
chances	chances
passer	pass
reste	rest
l'été	the summer
enfermé	locked
placard	closet
l'escalier	the stairs
précisément	precisely
cause	cause
domiciliée	domiciled
4	4
privet	privet
drive	drive
jamais	never
eu	had
loisir	leisure
d'apprécier	enjoy
l'oncle	uncle
vernon	vernon
tante	aunt
pétunia	petunia
leur	their
fils	son
dudley	dudley
seuls	only
parents	parents
encore	yet
vivants	living
ils	they
appartenaient	belonged
monde	world
avaient	had
attitude	attitude
très	very
médiévale	medieval
père	father
mère	mother
eux-mêmes	themselves
sorciers	wizards
morts	dead
depuis	since
longtemps	for a long time
on	it
n'évoquait	did
souvenir	remember
toit	roof
pendant	during
années	years
espéré	hoped
tyrannisant	tyrannisant
parviendraient	would
détruire	destroy
y	there
magique	magic
grande	great
fureur	fury
leurs	their
efforts	efforts
s'étaient	had
révélés	revealed
vains	in vain
vivaient	lived
présent	this
hantise	haunting
qu'un	a
jour	day
quelqu'un	someone
finisse	finish
découvrir	discover
deux	two
ans	years
suivait	followed
études	studies
collège	college
poudlard	hogwarts
l'école	the school
pouvaient	could
interdire	ban
catégoriquement	categorically
parler	talk
aux	the
voisins	neighbors
mettre	put
clé	key
dès	as soon
grimoires	grimoires
baguette	wand
chaudron	cauldron
balai	broom
l'empêcher	prevent
s'en	in
servir	serve
l'impossibilité	the impossibility
consulter	consult
livres	books
compliquait	complicated
vie	life
professeurs	teachers
donné	given
nombreux	many
difficile	difficult
d'entre	of
eux	them
destiné	for
professeur	professor
rogue	rogue
potion	potion
ratatinage	ratatinage
aucune	no
sympathie	sympathy
celui-ci	it
aurait	would
été	been
ravi	ravi
infliger	inflict
retenue	withholding
mois	months
entier	integer
s'il	if it
ne	do
apportait	brought
pas	not
devoir	duty
date	date
prévue	provided
aussi	also
avait-il	had he
saisi	seized
l'occasion	the opportunity
offerte	available
première	first
semaine	week
sortis	out
jardin	garden
admirer	admire
nouvelle	new
voiture	car
s'extasiant	if extasiant
bruyamment	loudly
voisinage	neighbourhood
soit	either
courant	current
s'était	had
glissé	slipped
rez-de-chaussée	ground floor
crocheté	crocheted
serrure	lock
pris	taken
quelques-uns	a few
cacher	hide
chambre	room
moment	time
veillait	watched
taches	spots
draps	sheets
s'apercevraient	would realize
passait	passed
partie	part
étudier	study
éviter	avoid
conflit	conflict
oncle	uncle
humeur	mood
égard	respect
déjà	already
exécrable	execrable
coup	blow
téléphone	phone
camarades	comrades
ron	ron
weasley	weasley
meilleurs	best
amis	friends
né	born
comptait	had
savait	knew
donc	so
beaucoup	a lot
choses	things
matière	material
revanche	contrast
malchance	bad luck
décroché	won
allô	hello
j'écoute	I listen to
trouvait	was
juste	just
côté	side
figé	frozen
place	place
entendant	hearing
voix	voice
s'élever	rise
combiné	combined
allo	allo
vous	you
m'entendez	hear me
je	I
veux	want to
À	To
criait	shouted
fort	fort
sursauté	startled
écartant	apart
vivement	strongly
regardait	watched
expression	expression
mêlée	melee
d'inquiétude	anxiety
parle	speaks
rugi	roared
direction	management
l'appareil	the device
Êtes-vous	Are you
répondu	answered
hurlant	screaming
trouvés	found
extrémités	ends
terrain	field
football	football
suis	am
camarade	comrade
d'École	School
petits	small
aussitôt	as soon
tournés	shot
vers	to
pétrifié	petrified
n'y	there
ici	here
tonné	thundered
tenant	taking into
bout	end
bras	arm
peur	fear
voir	see
exploser	explode
sais	know
quelle	what
École	School
parlez	talk
tÉlÉphonez	call
approchez	approach
ma	my
jeté	cast
socle	base
agi	acted
araignée	spider
venimeuse	venomous
subi	suffered
pires	the worst
débordements	overflows
eût	had
connus	known
comment	how
oses-tu	dare you
donner	give
notre	our
numÉro	number
tÉlÉphone	phone
gens	people
toi	you
tempêté	tempêté
l'inondant	the flooding
postillons	talking to them
toute	any
évidence	obviously
rendu	rendering
compte	account
attiré	attracted
ennuis	trouble
rappelé	recalled
hermione	hermione
granger	granger
meilleure	best
amie	friend
essayé	tried
l'appeler	the call
doutait	doubted
conseillé	recommended
téléphoner	call
dommage	damage
élève	student
classe	class
elle	it
n'aurait	would
commis	committed
l'imprudence	the imprudence
dire	say
condisciple	classmate
ainsi	as well
cinq	five
longues	long
semaines	weeks
ces	these
révélaient	revealed
presque	almost
détestables	detestable
celles	those
dernière	last
petite	small
amélioration	improvement
après	after
avoir	have
juré	juror
l'utiliserait	the use
envoyer	send
lettres	letters
autorisé	authorized
laisser	let
hedwige	hedwig
chouette	owl
promener	walk
librement	freely
fini	finished
céder	assign
fin	end
vacarme	din
lorsqu'elle	when it
restait	remained
enfermée	locked
trop	too
cage	cage
acheva	completed
notes	notes
s'interrompit	if interrupted
nouveau	new
lointains	distant
ronflements	snoring
énorme	huge
cousin	cousin
rompaient	breaking
silence	silence
régnait	reigned
maison	home
devait	should
tard	later
sentait	felt
picotements	tingling
trahissaient	betrayed
fatigue	fatigue
estima	estima
préférable	best
finir	finish
lendemain	next day
reboucha	reboucha
enveloppa	wrapped
vieille	old
taie	pillowcase
d'oreiller	pillow
leva	rose
alla	alla
lame	blade
parquet	parquet
branlante	rocky
dissimulée	concealed
releva	rose
s'étira	stretched
regarda	looked at
l'heure	the time
cadran	dial
lumineux	bright
réveil	alarm clock
posé	asked
table	table
heure	time
matin	morning
sentit	felt
étrange	strange
contraction	contraction
estomac	stomach
treize	thirteen
même	even
aperçu	overview
trait	related
inhabituel	unusual
personnalité	personality
peu	little
d'enthousiasme	enthusiasm
ressentait	felt
l'approche	the approach
anniversaire	anniversary
reçu	received
carte	card
souhaiter	wish
dernières	last
n'avaient	had
peine	penalty
fêter	celebrate
raison	reason
qu'ils	they
souviennent	remember
davantage	more
cette	this
année	year
traversa	crossed
pièce	room
plongée	diving
l'obscurité	the dark
passa	spent
devant	before
vide	empty
d'hedwige	of hedwig
ouvrir	open
fenêtre	window
s'appuya	leaned
rebord	rim
appréciant	enjoying
fraîcheur	freshness
l'air	the air
nocturne	night
visage	face
passé	past
maintenant	now
nuits	nights
qu'hedwige	that hedwig
n'était	there was
rentrée	back to school
inquiet	worried
–	-
arrivé	arrived
s'absenter	miss
espérait	hoped
cependant	however
serait	would be
bientôt	soon
retour	return
seul	only
vivant	living
mouvement	movement
recul	decline
voyant	light
fût	was
petit	small
maigre	lean
âge	age
grandi	grew up
plusieurs	several
centimètres	centimeters
cours	during
écoulée	past
cheveux	hair
noir	black
jais	jet
changé	changed
bataille	battle
restaient	remained
obstinément	stubbornly
rétifs	obstinate
tous	all
coiffer	hair
derrière	behind
brillaient	shone
vert	green
étincelant	sparkling
front	front
parfaitement	perfectly
visible	visible
mèche	wick
dessinait	drew
mince	thin
cicatrice	scar
forme	form
d'éclair	flash
représentait	represented
chez	in
contrairement	unlike
prétendu	alleged
dix	ten
l'accident	the accident
tué	killed
bonne	good
lily	lily
james	james
n'étaient	there were
accident	accident
route	road
assassinés	murdered
mage	mage
redoutable	formidable
qu'on	we
ait	has
connu	known
lord	lord
voldemort	voldemort
survécu	survived
l'attaque	the attack
tirant	pulling
lieu	place
tuer	kill
sort	fate
lancé	launched
retourné	returned
contre	against
auteur	author
maléfique	evil
dû	due
fuite	leak
état	state
proche	close
mort	death
entré	entered
retrouvé	found
face	in the face of
l'effroyable	the appalling
accoudé	leaning
contemplait	contemplated
ciel	sky
disant	saying
chance	chance
pouvoir	power
atteindre	reach
treizième	thirteenth
scruta	watched
l'espoir	hope
d'apercevoir	see
peut-être	maybe
allait-elle	would she
apparaître	appear
bec	bec
cadavre	corpse
souris	mouse
apporterait	would
s'attendant	expecting
recevoir	receive
félicitations	congratulations
regard	look
perdu	lost
toits	roofs
maisons	houses
environnantes	surrounding
quelques	a few
secondes	seconds
rendre	make
silhouette	silhouette
découpée	cut
lueur	glow
lune	moon
créature	creature
étrangement	strangely
penchée	leaning
battait	beat
ailes	wings
volant	steering wheel
immobile	still
descendre	down
fraction	fraction
seconde	second
hésita	hesitated
poignée	handle
demandant	asking
ferait	would
mieux	better
refermer	close
au-	at-
dessus	top
réverbère	street light
vit	lives
quoi	what
trois	three
hiboux	owls
s'engouffrèrent	if engouffrèrent
ouverte	open
portaient	wore
troisième	third
évanoui	fainted
atterrirent	landed
bruit	noise
mou	soft
bascula	tilt
dos	back
croix	cross
paquet	package
attaché	attached
pattes	legs
reconnut	recognized
inanimé	inanimate
gros	wholesale
oiseau	bird
gris	grey
s'appelait	called
errol	errol
appartenait	belonged
précipita	rushed
détacha	detached
ficelle	string
autour	around
prit	took
porta	porta
entrouvrit	entrouvrit
œil	eye
vitreux	glassy
laissa	let
échapper	escape
faible	low
hululement	howling
guise	as
remerciement	thank you
boire	drink
l'eau	the water
gorgées	sips
tourna	turned
autres	other
oiseaux	birds
d'eux	of them
plumage	plumage
blanc	white
neige	snow
portait	wore
contente	happy
d'elle	it
donna	donna
affectueux	loving
tandis	while
enlevait	removed
fardeau	burden
d'aile	wing
rejoindre	join
connaissait	knew
magnifique	beautiful
fauve	fawn
sut	sut
suite	suite
d'où	where
venait	came
lettre	letter
laquelle	which
immédiatement	immediately
sceau	seal
l'eut	had
délivré	issued
courrier	mail
l'oiseau	the bird
ébouriffa	ruffled
plumes	feathers
air	air
avantageux	advantageous
déploya	deployed
s'envola	flew
profondeurs	depths
s'assit	sat
qu'avait	that was
apporté	brought
arracha	tore
papier	paper
kraft	kraft
protégeait	protected
découvrit	discovered
cadeau	gift
enveloppé	wrapped
doré	golden
d'anniversaire	birthday
reçue	received
doigts	fingers
légèrement	slightly
tremblants	trembling
ouvrit	opened
l'enveloppe	the envelope
s'échappèrent	escaped
morceaux	pieces
coupure	cut
journal	journal
provenait	came
gazette	gazette
personnages	characters
représentés	represented
photo	photo
accompagnait	accompanied
l'article	article
cessaient	stopped
bouger	move
lissa	lissa
morceau	song
employÉ	employee
ministÈre	department
remporte	wins
grand	great
prix	price
arthur	arthur
directeur	director
service	service
détournements	diversions
l'artisanat	crafts
moldu	muggle
remporté	won
loterie	lottery
gallion	gallion
organisée	organized
chaque	each
mr	mr
nous	we
déclaré	said
or	gold
va	will
voyage	travel
egypte	egypt
où	where
trouve	find
bill	bill
aîné	elder
travaille	works
là-bas	there
conjureur	conjureur
sorts	spells
banque	bank
gringotts	gringotts
sera	will be
classes	classes
enfants	children
poursuivent	continue
examina	examined
photographie	photography
animée	animated
sourire	smile
éclaira	lit
lorsqu'il	when it
neuf	nine
grands	great
signes	signs
pyramide	pyramid
égyptienne	egyptian
mrs	mrs
dodue	plump
haute	high
crâne	skull
chauve	bald
six	six
garçons	boys
fille	girl
roux	roux
éclatant	bright
(bien	(well
impossible	impossible
blanc)	white)
dégingandé	lanky
centre	centre
cliché	snapshot
rat	rat
croûtard	croûtard
l'épaule	the shoulder
enlacée	interlaced
sœur	sister
ginny	ginny
personne	person
mérité	deserved
gagner	win
joli	nice
tas	heap
d'or	gold
extrêmement	extremely
pauvres	poor
générosité	generosity
sans	without
égale	equal
déplia	unfold
cher	dear
joyeux	happy
désolé	sorry
j'espère	I hope
t'en	you
ont	have
voulu	wanted
j'en	I
ai	I
parlé	spoken
papa	dad
m'a	me
dit	said
n'aurais	would have
crier	shout
ça	it
l'egypte	egypt
c'est	it is
formidable	great
montré	shown
tombeaux	tombs
pharaons	the pharaohs
tu	you
peux	can
imaginer	imagine
mauvais	bad
égyptiens	egyptians
jetés	thrown
protéger	protect
maman	mom
interdit	prohibited
visiter	visit
dernier	last
tombeau	tomb
squelettes	skeletons
mutants	mutants
c'étaient	it was
restes	remains
entrer	enter
retrouvés	found
tètes	heads
d'autres	other
trucs	tips
genre-là	like that
j'ai	I
mal	evil
croire	believe
quand	when
gagné	won
lot	lot
sept	seven
cents	cents
gallions	galleons
dépensé	spent
rester	stay
suffisamment	enough
mes	my
puissent	can
m'acheter	buy me
souvenait	remember
circonstances	circumstances
lesquelles	which
cassée	broken
soir-là	evening
arrivés	arrived
volante	flying
écrasés	crushed
arbre	tree
parc	park
serons	will be
environ	about
avant	before
ira	ira
londres	london
chercher	search
nos	our
manuels	manuals
scolaires	school
pourras	can
retrouver	find
te	te
laisse	leaves
essaye	try
venir	come
p	p
-s	-s
percy	percy
nommé	named
préfet-en-chef	prefect-in-chief
allait	would
septième	seventh
bombait	bombait
torse	torso
insigne	badge
épingle	pin
fez	fez
fièrement	proudly
soigneusement	carefully
coiffés	styled
monture	mount
d'écaillé	of chipped off
étincelaient	sparkled
soleil	sun
d'egypte	egypt
déballa	déballa
boîte	box
quelque	some
chose	thing
ressemblait	looked like
toupie	spinning top
verre	glass
mot	word
s'agit	is
scrutoscope	scrutoscope
poche	pocket
peut	can
confiance	trust
parages	area
doit	must
normalement	normally
s'allumer	turn on
tourner	turn
prétend	claims
attrape-nigaud	catch-wuss
vend	sells
font	do
tourisme	tourism
s'y	there
fier	proud
prétexte	excuse
est	is
resté	stayed
allumé	on
dîner	dinner
hier	yesterday
soir	evening
fred	fred
george	george
mis	put
scarabées	beetles
soupe	soup
salut	hi
posa	posa
chevet	bedside
resta	remained
équilibre	balance
reflétant	reflecting
aiguilles	needles
lumineuses	bright
contempla	stared at
satisfaction	satisfaction
s'intéressa	if interested
contenait	contained
d'hermione	of hermione
raconté	told
ton	your
n'as	did
d'ennuis	trouble
france	france
me	me
demandais	wondering
j'allais	I was going to
parvenir	send
j'avais	I had
l'ouvrent	the open
douane	customs
heureusement	fortunately
arrivée	arrival
croîs	croîs
voulait	wanted
sûre	safe
t'envoie	sends you
fois-ci	time
trouvé	found
grâce	thanks
société	company
vente	sale
fait	fact
annonce	ad
(je	(I
fais	do
tellement	so
contact	contact
sorcellerie)	witchcraft)
as	as
vu	seen
apprendre	learn
savoir	know
quel	what
l'envie	the desire
ancienne	old
fascinants	fascinating
histoires	stories
intéressantes	interesting
régionale	regional
entièrement	fully
récrit	rewritten
mon	my
d'histoire	history
inclure	include
certaines	some
découvertes	discoveries
copie	copy
n'est	there is
longue	long
rouleaux	rolls
binns	binns
demandé	asked
est-ce	is this
ta	your
laisseront	let
oui	yes
sinon	otherwise
verrai	see
er	er
septembre	September
amitiés	friendships
nomme	appoints
enchante	enchants
n'a	did
trouver	find
réjouissant	pleasing
éclata	broke out
rire	laugh
reposant	based
envoyé	sent
lourd	heavy
connaissant	knowing
s'attendait	expected
formules	formulas
extrême	extreme
difficulté	difficulty
cœur	heart
bond	bond
poitrine	chest
déchira	rent
étui	case
lequel	which
grave	serious
d'argent	money
nécessaire	necessary
hou	hou
là	there
murmura-t-il	he murmured
faisant	making
glisser	drag
fermeture	closure
Éclair	Flash
l'étui	the case
crème	cream
polir	Polish
spéciale	special
manche	sleeve
paire	pair
cisailles	shears
brindilles	twigs
argent	money
minuscule	tiny
boussole	compass
cuivre	copper
attacher	attach
longs	long
voyages	travel
manuel	manual
d'entretien	maintenance
balais	brushes
dehors	outside
manquait	missing
loin	far
quidditch	quidditch
sport	sport
dangereux	dangerous
passionnant	exciting
pratiquait	practiced
particulièrement	particularly
apprécie	appreciate
excellent	excellent
joueur	player
jeune	young
sélectionné	selected
équipe	team
course	race
superbe	superb
nimbus	nimbus
2000	2000
nul	no
doute	doubt
l'une	one
auxquelles	which
l'écriture	writing
brouillonne	messy
expéditeur	sender
hagrid	hagrid
garde-chasse	gamekeeper
aperçut	saw
objet	object
déballer	unpack
contenu	content
frémir	simmer
série	series
bruits	noise
secs	dry
sonores	sound
claquements	clicks
mâchoires	jaws
figea	froze
volontairement	voluntarily
notion	concept
danger	danger
moyenne	average
normaux	normal
n'ignorait	acknowledging
éprouvait	felt
tendresse	tenderness
araignées	spiders
géantes	giant
empressé	quick
d'acheter	buy
chien	dog
têtes	heads
étranger	foreign
rencontré	met
pub	pub
dissimulait	hid
volontiers	happy
œufs	eggs
dragon	dragon
cabane	hut
précaution	caution
appuya	supported
doigt	finger
émit	issued
saisissant	entering
au-dessus	above
prêt	loan
frapper	hit
attrapa	caught
pouce	inch
l'index	the index
enveloppait	enveloped
tira	drew
tomber	fall
eut	had
remarquer	notice
élégante	elegant
couverture	coverage
verte	green
gravé	engraved
titre	title
monstrueux	monstrous
monstres	monsters
l'objet	the object
dresse	provides
bord	edge
reliure	binding
mette	mette
crabe	crab
saugrenu	wackiness
aïe	ouch
marmonna	muttered
sauta	jumped
sourd	deaf
rapidement	quickly
réfugier	refuge
bureau	office
priant	praying
réveillent	wake up
quatre	four
essaya	tried
l'attraper	the catch
ouille	ouch
referma	closed
violemment	violently
continuant	continuing
déplacer	move
bords	edges
ouvrait	opened
refermait	closing
rua	rua
parvint	managed
l'aplatir	flatten
sol	soil
voisine	nearby
sommeil	sleep
grognement	grunt
sonore	sound
intéressés	interested
regardèrent	looked
serrer	tighten
débattait	struggling
précipiter	rush
commode	convenient
sortir	out
ceinture	belt
boucla	roped off
étroitement	closely
frémit	shudders
colère	anger
pouvait	could
remuer	stir
jeta	threw
pensé	thought
pourrait	could
t'être	you be
utile	useful
n'en	do
dis	say
parlerai	talk about
verra	see
traitent	treat
convenablement	properly
affection	affection
inquiétant	worrying
estime	estimated
posséder	have
mordeur	biter
scolaire	school
l'essentiel	the essential
cartes	cards
rassembla	together
large	wide
qu'à	as
lire	read
remarquant	noticing
épaisse	thick
d'habitude	usually
retira	retired
premier	first
voudrez	want to
note	note
commencera	begin
partira	will leave
gare	station
king's	king's
cross	cross
quai	dock
n°9	n°9
3/4	3/4
onze	eleven
heures	hours
précises	accurate
lors	when
certains	some
week-ends	weekends
élèves	students
auront	will
possibilité	possibility
village	village
pré-au-lard	pre-to-bacon
signer	sign
parent	parent
responsable	responsible
l'autorisation	the authorization
sortie	output
ci-jointe	attached
trouverez	find
pli	fold
liste	list
seront	will be
nécessaires	needed
sentiments	feelings
m	m
mcgonagall	mcgonagall
directrice-adjointe	assistant director
d'œil	eye
formulaire	form
d'autorisation	authorization
s'effaça	vanished
week-end	weekend
peuplé	populated
pieds	feet
pouvait-il	could he
espérer	hope
convaincre	convince
indiquait	indicated
d'oublier	forget
jusqu'au	until the
remit	gave
traça	drew
calendrier	calendar
compter	from
jours	days
séparaient	separated
enleva	removed
s'allongea	lain
ouverts	open
contemplant	contemplating
cela	this
puisse	can
paraître	look
l'impression	printing
d'être	to be
content	content
celui	the
