22	22
encore	yet
du	the
courrier	mail
harry	harry
hermione	hermione
le	the
tirait	drew
par	by
la	the
manche	sleeve
l'oeil	the eye
fixé	set
sur	on
cadran	dial
de	of
sa	its
montre	watch
on	it
a	has
exactement	exactly
dix	ten
minutes	minutes
pour	for
revenir	return
à	to
l'infirmerie	the infirmary
sans	without
qu'on	we
nous	we
voie	way
avant	before
que	that
dumbledore	dumbledore
ne	do
verrouille	locks
porte	door
d'accord	agreement
dit	said
en	in
détournant	diverting
son	its
regard	look
ciel	sky
allons-y	let's go
ils	they
franchirent	crossed
qui	that
se	is
trouvait	was
derrière	behind
eux	them
et	and
descendirent	went down
un	a
petit	small
escalier	staircase
pierre	stone
colimaçon	spiral
arrivés	arrived
au	the
bas	the bottom
des	of
marches	steps
entendirent	heard
voix	voice
plaquèrent	plaquèrent
aussitôt	as soon
contre	against
mur	wall
écoutèrent	listen
c'étaient	it was
les	the
fudge	fudge
rogue	rogue
avançaient	advanced
grands	great
pas	not
long	long
couloir	hallway
j'espère	I hope
simplement	simply
va	will
faire	do
difficultés	difficulties
disait	said
baiser	fuck
être	be
donné	given
tout	all
suite	suite
dès	as soon
macnair	macnair
sera	will be
retour	return
avec	with
détraqueurs	détraqueurs
l'affaire	the case
black	black
été	been
extrêmement	extremely
embarrassante	embarrassing
inutile	useless
vous	you
dire	say
j'attends	I'm waiting for
impatience	impatience
pouvoir	power
annoncer	announce
gazette	gazette
sorcier	sorcerer
l'avons	have
enfin	finally
capturé	captured
je	I
serais	would be
étonné	surprised
qu'ils	they
souhaitent	wish
interviewer	interview
mon	my
cher	dear
jeune	young
potter	potter
aura	will
retrouvé	found
ses	its
esprits	spirits
pense	think
qu'il	it
hâte	looking forward
raconter	tell
comment	how
lui	him
avez	have
sauvé	saved
vie	life
serra	serra
dents	teeth
il	it
aperçut	saw
sourire	smile
satisfait	satisfied
lorsqu'il	when it
passa	spent
devant	before
leur	their
cachette	cache
compagnie	company
bruit	noise
leurs	their
s'évanouit	faints
bout	end
attendirent	waited for
instant	now
s'assurer	ensure
étaient	were
véritablement	truly
partis	parties
puis	then
coururent	ran
dans	in
direction	management
opposée	opposite
autre	other
suivirent	followed
alors	then
caquètement	chatter
peu	little
plus	more
loin	far
peeves	peeves
murmura	whispered
saisissant	entering
poignet	wrist
d'hermione	of hermione
vite	fast
s'engouffrèrent	if engouffrèrent
juste	just
temps	time
une	a
classe	class
déserte	deserted
gambadait	gambadait
airs	air
riant	laughing
aux	the
éclats	shards
est	is
vraiment	really
abominable	abominable
l'oreille	the ear
collée	stuck
doit	must
excité	excited
parce	because
s'apprêtent	preparing
finir	finish
sirius	sirius
elle	it
regarda	looked at
n'a	did
trois	three
ricanements	sneers
soient	are
évanouis	faded
sortirent	went out
remirent	put
courir	run
qu'est-ce	what is this
passera	will
si	if
n'est	there is
demanda	asked
respiration	breathing
haletante	panting
préfère	prefer
y	there
penser	think
gémit	moans
regardant	looking at
nouveau	new
qu'une	a
minute	minute
menait	led
Ça	It
j'entends	I hear
s'avancèrent	advanced
silencieusement	silently
s'ouvrit	opened
apparut	appeared
dos	back
vais	'll
verrouiller	lock
minuit	midnight
moins	less
cinq	five
dit-il	he said
consultant	consultant
miss	miss
granger	granger
tours	towers
devraient	should
suffire	suffice
bonne	good
chance	chance
sortit	went out
ferma	closed
s'apprêta	if apprêta
l'aide	using
baguette	wand
magique	magic
pris	taken
panique	panic
toutes	all
jambes	legs
tourna	turned
vers	to
large	wide
dessina	drew
sous	under
longue	long
moustache	mustache
argentée	silver
demanda-t-il	he asked
basse	low
réussi	successful
répondit	replied
hors	out
d'haleine	breath
s'est	is
enfui	away
s'envolant	flying
buck	buck
eut	had
rayonnant	radiant
bravo	bravo
crois	believe
–	-
tendit	handed
oui	yes
êtes	are
déjà	already
allez	go
recoucher	go back to bed
enfermer	lock
glissèrent	glissèrent
salle	room
où	where
n'y	there
avait	had
personne	person
dehors	outside
ron	ron
toujours	always
endormi	asleep
lit	bed
lorsque	when
serrure	lock
cliqueta	cliqueta
recouchèrent	recouchèrent
propres	own
lits	beds
tard	later
madame	mrs.
pomfresh	pomfresh
bureau	office
s'avança	advanced
directeur	director
parti	party
m'occuper	take care
mes	my
patients	patients
maintenant	now
était	was
d'une	a
humeur	mood
massacrante	massacring
prirent	took
docilement	obediently
chocolat	chocolate
resta	remained
auprès	with
d'eux	of them
mangeaient	ate
jusqu'à	up to
dernière	last
miette	crumb
mais	but
mal	evil
avaler	swallow
attendaient	waiting
aguets	watch
nerfs	nerves
tendus	tense
prenaient	took
quatrième	fourth
morceau	song
tendait	tended
hurlements	howling
colère	anger
répercutaient	pass
écho	echo
quelque	some
part	share
au-dessus	above
tête	head
c'est	it is
ça	it
d'un	a
air	air
inquiet	worried
entendaient	heard
présent	this
furieuses	furious
rapprochaient	closer
vont	go
réveiller	wake up
monde	world
est-ce	is this
croient	believe
essaya	tried
comprendre	understand
ce	this
disaient	said
dû	due
transplaner	transplaner
severus	severus
aurait	would
fallu	had to
laisser	let
quelqu'un	someone
pièce	room
quand	when
savoir	know
transplanÉ	transplanÉ
rugit	roars
semblait	seemed
proche	close
impossible	impossible
À	To
l'intÉrieur	inside
chÂteau	castle
suis	am
sÛr	course
coup	blow
soyez	be
raisonnable	reasonable
enfermé	locked
bang	bang
volée	fly
firent	did
irruption	burst
seul	only
parfaitement	perfectly
calme	quiet
même	even
l'air	the air
s'amuser	have fun
paraissait	seemed
suffit	just
cria-t-il	he shouted
fabriquÉ	manufactured
professeur	professor
s'indigna	grew indignant
contrôlez-vous	control-you
prie	pray
allons	will
cette	this
verrouillée	locked
bien	well
vu	seen
l'ont	have
aidÉ	helped
s'enfuir	escape
sais	know
hurla	screamed
pointant	pointing
l'index	the index
traits	features
visage	face
convulsés	troubled
vociférations	cries
s'accompagnaient	accompanied
nuage	cloud
postillons	talking to them
calmez-vous	calm down
lança	launched
dites	tell
sens	meaning
connaissez	know
s'écria	cried
fait	fact
tranquillement	quietly
réfléchissez	think about it
depuis	since
j'ai	I
quitté	left
avez-vous	have you
ces	these
élèves	students
quitter	leave
sûr	course
non	not
répliqua	replied
exaspérée	exasperated
ai	I
quittés	left
voyez	see
vouliez	want to
croire	believe
ont	have
faculté	faculty
trouver	find
deux	two
endroits	places
différents	different
vois	see
raison	reason
importuner	annoy
davantage	more
immobile	still
bouillant	boiling
rage	rage
alternativement	alternatively
outré	outraged
conduite	conduct
dont	which
yeux	eyes
pétillaient	pétillaient
lunettes	glasses
soudain	suddenly
talons	heels
pans	pans
robe	dress
tourbillonnant	swirling
sillage	wake
quitta	left
furieux	furious
bonhomme	man
me	me
semble	seems
très	very
équilibré	balanced
sortir	out
j'étais	I was
surveillerais	surveillerais
près	near
oh	oh
déséquilibré	unbalanced
ton	your
subi	suffered
profonde	deep
contrariété	annoyance
soupira	sighed
s'en	in
donner	give
cœur	heart
joie	joy
avions	aircraft
filer	spinning
entre	between
doigts	fingers
fois	time
manquerait	missing
apprenne	learn
fuite	leak
cet	this
hippogriffe	hippogriffe
serai	am
risée	laughing-stock.
ferais	would
retourner	return
ministère	department
expliquer	explain
passé	past
j'imagine	I guess
n'allez	not going to
abords	around
l'école	the school
effet	effect
n'ont	have
rien	nothing
ici	here
désormais	now
passant	from
machinalement	going through the motions
cheveux	hair
jamais	never
n'aurais	would have
pensé	thought
essaieraient	try
garçon	boy
innocent	innocent
contrôler	control
renvoyer	return
azkaban	azkaban
soir	evening
pourrions	could
peut-être	maybe
poster	post
dragons	dragons
entrées	entries
hagrid	hagrid
serait	would be
enchanté	enchanted
adressant	sending
complice	accomplice
hâta	haste
marmonnant	mumbling
paroles	lyrics
incompréhensibles	incomprehensible
retourna	returned
ensuite	then
gémissement	moaning
l'autre	the other
venait	came
redressa	straightened
autour	around
massant	massaging
grogna-t-il	"he grunted
là	there
lupin	lupin
échangèrent	exchanged
toi	you
racontes	talking about
reprenant	taking
lorsqu'ils	when they
quittèrent	left
lendemain	next day
midi	midi
retrouvèrent	found
château	castle
presque	almost
désert	desert
chaleur	heat
étouffante	stifling
fin	end
examens	reviews
avaient	had
incité	prompted
profiter	enjoy
sortie	output
pré-au-lard	pre-to-bacon
ni	or
n'avaient	had
envie	want
d'aller	go
rejoindre	join
autres	other
préférant	preferring
promener	walk
parc	park
assis	sitting
bord	edge
lac	lake
demandaient	asked
pouvaient	could
perdit	lost
fil	wire
conversation	conversation
regardait	watched
rive	shore
cerf	deer
galoper	gallop
nuit	night
précédente	previous
ombre	shadow
enveloppa	wrapped
virent	saw
apparaître	appear
s'essuyait	wiped her
mouchoir	handkerchief
taille	size
nappe	tablecloth
vitreux	glassy
arborait	sported
grand	great
devrais	should
content	content
hier	yesterday
devinez	guess
arrivé	arrived
quoi	what
demandèrent-ils	asked-they
faisant	making
semblant	pretend
d'avoir	to have
curieux	curious
échappé	escaped
libre	free
fêté	celebrated
toute	any
merveilleux	wonderful
s'exclama	exclaimed
jetant	throwing
noir	black
point	point
d'éclater	burst
rire	laugh
n'ai	haven
l'attacher	attach
assez	enough
solidement	securely
reprit	took
matin	morning
j'avais	I had
peur	fear
soit	either
tombé	fallen
affirme	says
dévoré	devoured
n'êtes	there are
courant	current
s'effaça	vanished
eût	had
alentours	around
baissa	lowered
poursuivit	continued
raconté	told
serpentard	slytherin
croyais	thought
savait	knew
l'heure	the time
loup-garou	loup-garou
liberté	freedom
valises	suitcases
pourquoi	why
surpris	surprised
ait	has
posé	asked
question	question
démission	resignation
première	first
heure	time
voulait	wanted
prendre	take
risque	risk
reproduise	again
releva	rose
bond	bond
aller	go
voir	see
s'il	if it
démissionné	resigned
puisse	can
grand-chose	much
m'est	I
égal	equal
veux	want to
retrouve	found
ouverte	open
fini	finished
ranger	ranger
affaires	business
l'aquarium	the aquarium
vide	empty
strangulot	strangulot
côté	side
vieille	old
valise	suitcase
penché	leaning
qu'en	in
entendant	hearing
frapper	hit
arriver	getting
montra	showed
parchemin	parchment
lequel	which
resté	stayed
c'était	it was
carte	card
maraudeur	marauder
viens	just
m'a	me
aviez	had
vrai	true
ouvrit	opened
tiroirs	drawers
commença	started
vider	empty
contenu	content
magie	magic
cru	raw
aidé	helped
n'est-ce	is this
alla	alla
fermer	close
répondit-il	he replied
convaincre	convince
essayé	tried
sauver	save
comble	fills
reçu	received
rude	rough
voyant	light
allait	would
perdre	lose
l'ordre	the order
merlin	merlin
donc	so
déjeuner	breakfast
heu	uh
accidentellement	accidentally
révélé	revealed
partir	from
cause	cause
las	las
demain	tomorrow
heure-ci	time
hiboux	owls
envoyés	sent
parents	parents
commencer	start
voudront	want to
enfants	children
aient	have
comme	as
après	after
comprends	understand
j'aurais	I would have
pu	could
mordre	bite
n'importe	any
d'entre	of
faut	must
cela	this
reproduire	reproduce
meilleur	best
défense	defence
forces	forces
eu	had
partez	go
hocha	hocha
silence	silence
continua	continued
d'après	after
reprit-il	"he said
plusieurs	several
personnes	people
chose	thing
fier	proud
progrès	progress
faits	facts
parlez-moi	talk to me
votre	your
patronus	patronus
savez-vous	do you know
j'en	I
créé	created
s'étonna	was surprised
sinon	otherwise
auriez-vous	would you
reculer	back
raconta	told
s'était	had
terminé	finished
père	father
transformait	transformed
deviné	guessed
l'appelait	the called
cornedrue	cornedrue
jeta	threw
derniers	last
livres	books
referma	closed
tenez	hold
rapporté	reported
cabane	hut
hurlante	howling
tendant	for
cape	cape
d'invisibilité	invisibility
hésita	hesitated
donna	donna
également	also
peux	can
rendre	make
ceci	this
sentir	feel
coupable	guilty
n'en	do
l'usage	the use
qu'elle	it
utile	useful
prit	took
m'avez	I have
lunard	lunard
queudver	queudver
patmol	patmol
voulaient	wanted
m'attirer	draw me
l'extérieur	outside
disiez	tell
trouveraient	find
drôle	funny
fermant	closing
n'hésite	do not hesitate
affirmer	say
james	james
singulièrement	singularly
déçu	disappointed
fils	son
n'avait	had
découvert	discovered
aucun	no
passages	passages
secrets	secrets
permettent	allow
frappa	hit
fourra	stuffed
précipitamment	hurriedly
poche	pocket
sembla	seemed
fiacre	fiacre
remus	remus
merci	thank you
monsieur	mr.
bon	good
eh	eh
revoir	review
souriant	smiling
plaisir	fun
avoir	have
élève	student
reverrons	again
jour	day
m'accompagner	accompany me
trouverai	find
chemin	path
l'impression	printing
possible	possible
sobrement	soberly
bras	arm
main	hand
adressa	addressed
signe	sign
bref	brief
s'assit	sat
terre	earth
sombre	dark
entendit	heard
refermer	close
as-tu	have you
accablé	overwhelmed
tu	you
contraire	contrary
change	exchange
amer	bitter
pettigrow	pettigrow
s'échapper	escape
as	as
révéler	reveal
vérité	truth
permis	permit
d'échapper	to escape
sort	fate
terrible	terrible
remua	stir
mémoire	memory
puissant	powerful
prédiction	prediction
trelawney	trelawney
examen	review
divination	divination
devenue	become
bizarre	weird
d'habitude	usually
grave	serious
roulait	travelling
serviteur	servant
voldemort	voldemort
partirait	would
maître	master
l'aiderait	help
retrouver	find
puissance	power
redevenue	again
normale	normal
souvenait	remember
véritable	true
parut	appeared
impressionné	impressed
songeur	pensive
voilà	this is
nombre	number
prédictions	predictions
vérifiées	verified
total	total
augmentation	increase
effaré	aghast
pouvait-il	could he
choses	things
aussi	also
calmement	calmly
empêché	prevented
tuer	kill
ma	my
faute	fault
revient	returns
paisible	peaceful
l'expérience	the experience
vécue	lived
retourneur	turner
t'a	you
appris	learned
conséquences	consequences
nos	our
actions	shares
sont	are
complexes	complex
diverses	various
prévoir	provide
l'avenir	the future
entreprise	company
difficile	difficult
preuve	proof
vivante	living
noble	noble
sauvant	saving
aide	using
reprendre	resume
te	te
envoyé	sent
dette	debt
envers	to
lorsqu'un	when a
sauve	saves
crée	creates
certain	some
lien	link
veuille	want to
moi	me
trahi	betrayed
s'agit	is
niveau	level
profond	deep
impénétrable	impenetrable
crois-	believe-
viendra	will come
seras	will be
parvenait	could
imaginer	imagine
qu'un	a
tel	such
lu	read
pensées	thoughts
connu	known
poudlard	hogwarts
douceur	smooth
épargné	spared
persuadé	persuaded
parlait	spoke
légère	light
voyais	saw
erreur	error
peut	can
d'entendre	to hear
ressembles	look like
manière	way
extraordinaire	extraordinary
ta	your
mère	mother
bête	beast
murmura-t-il	he murmured
savais	knew
mort	death
morts	dead
avons	have
aimés	loved
quittent	leave
souvenons	remember
clairement	clearly
sommes	are
détresse	distress
vit	lives
besoin	need
aurais-tu	would you
créer	create
particulier	particular
revenu	income
fallut	took
quelques	a few
instants	moments
devenus	become
animagi	animagi
exploit	feat
l'avoir	have
insu	blind
rappelé	recalled
forme	form
inattendue	unexpected
qu'avait	that was
prise	outlet
attaqué	attacked
mr	mr
malefoy	malfoy
déguisé	disguised
détraqueur	détraqueur
match	match
serdaigle	ravenclaw
l'as	the ace
laissant	leaving
brouillaient	blurred my
seuls	only
s'étaient	had
enfuis	fled
mesure	measurement
qu'approchait	that was approaching
classes	classes
entendait	heard
théories	theories
prétendaient	claimed
événements	events
aucune	no
ressemblait	looked like
fût	was
certitude	certainty
arrangé	arranged
mettre	put
l'abri	the shelter
berner	berner
garde-chasse	gamekeeper
percy	percy
weasley	weasley
beaucoup	a lot
j'arrive	I can
entrer	enter
j'aurai	I will have
proposer	offer
respecter	respect
loi	law
affirmait-il	he said
seule	only
consentait	granted
l'écouter	listen
c'est-à-dire	that is to say,
pénélope	penelope
petite	small
amie	friend
idéal	ideal
l'atmosphère	the atmosphere
joyeuse	joyful
l'impossible	the impossible
aider	help
pourtant	yet
senti	felt
déprimé	depressed
période	period
l'année	the year
n'était	there was
regretter	regret
départ	starting
tous	all
cours	during
attristés	sorry
demande	request
prochaine	next
sombrement	darkly
seamus	seamus
finnigan	finnigan
vampire	vampire
suggéra	suggested
dean	dean
thomas	thomas
nuance	nuance
d'espoir	hope
seulement	only
préoccupait	concern
pouvait	could
s'empêcher	help
souvent	often
demandait	asked
cesse	stops
Était-il	Was it
sûreté	safety
l'accablait	the dislocated
perspective	perspective
devoir	duty
chez	in
dursley	dursley
pendant	during
environ	about
demi-heure	a half-hour
magnifique	beautiful
irait	would
vivre	live
ami	friend
nouvelles	new
car	because
signifiait	meant
cacher	hide
ressentir	feel
tristesse	sadness
pensant	thinking
maison	home
rêve	dream
résultats	results
furent	were
affichés	posted
dernier	last
trimestre	quarter
épreuves	tests
stupéfait	stunned
obtenu	obtained
potions	potions
soupçonnait	suspected
d'être	to be
intervenu	intervened
empêcher	prevent
recaler	readjust
volontairement	voluntarily
comportement	behavior
semaine	week
paru	published
inquiétant	worrying
n'aurait	would
pût	could
détester	hate
cas	case
chaque	each
tic	ict
agitait	agitated
coin	corner
bouche	mouth
cessait	stopped
remuer	stir
rêvé	dreamed
serrer	tighten
cou	neck
aspic	aspic
fred	fred
george	george
buse	nozzle
surcroît	moreover
gryffondor	gryffindor
grâce	thanks
notamment	in particular
prouesses	feats
terrain	field
quidditch	quidditch
gagné	won
coupe	cup
quatre	four
maisons	houses
troisième	third
année	year
consécutive	consecutive
grande	great
fut	was
décorée	decorated
couleurs	colors
rouge	red
or	gold
banquet	banquet
d'année	of the year
table	table
vainqueurs	winners
bruyante	noisy
soir-là	evening
parvint	managed
fête	feast
oubliant	forgetting
faudrait	should
express	express
gare	station
annonça	announced
nouvelle	new
surprenante	surprising
allée	alley
mcgonagall	mcgonagall
dit-elle	she said
décidé	decided
d'abandonner	to abandon
l'étude	the study
moldus	muggle
cent	cent
vingt	twenty
bonnes	good
réponses	answers
pourrai	can
supporter	bear
celle-	the
ci	it
rendait	made
folle	crazy
l'ai	I
rendu	rendering
emploi	employment
normal	normal
aies	have
ronchonna	ronchonna
normalement	normally
tes	your
amis	friends
promis	promised
sévère	severe
disparaître	disappear
montagne	mountain
attendre	wait
mois	months
sois	am
triste	sad
pensais	thought
vacances	holiday
j'y	I
viennes	come
j'arrangerai	I will try
t'appellerai	you'll call
servir	serve
fêlétone	fêlétone
téléphone	phone
rectifia	modified
étudier	study
dis	say
ira	ira
ensemble	all
s'arrange	arranges
billets	tickets
proposition	proposal
remonter	back
sensiblement	significantly
moral	moral
seront	will be
ravis	happy
surtout	especially
tante	aunt
marge	margin
l'après-midi	in the afternoon
excellente	excellent
gaieté	gaiety
tourné	shot
fenêtre	window
d'oeil	eye
au-dehors	outside
boule	ball
grise	grey
d'apparaître	to appear
vitre	glass
leva	rose
mieux	better
minuscule	tiny
hibou	owl
portait	wore
lettre	letter
trop	too
peine	penalty
voler	fly
remous	whirlpool
d'air	air
provoqués	caused
vitesse	speed
train	train
d'ouvrir	open
attrapa	caught
l'oiseau	the bird
vif	bright
d'or	gold
peluche	plush
laissa	let
tomber	fall
banquette	bench
mit	mit
voleter	fly
joyeux	happy
compartiment	compartment
accompli	accomplished
mission	mission
hedwige	hedwig
fit	fit
claquer	slam
bec	bec
désapprobation	disapproval
pattenrond	pattenrond
suivit	followed
jaunes	yellow
protéger	protect
adressée	addressed
l'enveloppe	the envelope
s'écrièrent	cried
lis-nous	lily-we
parviendra	will
n'arrives	can't seem
oncle	uncle
j'ignore	I don't know
s'ils	if they
l'habitude	the usual
recevoir	receive
postal	postal
cachons	hide
dirai	tell
tomberait	fall
mauvaises	bad
mains	hands
confiance	trust
j'aie	I have
trouvé	found
travail	work
cherchent	seek
trouveront	find
m'arranger	fix me
m'aperçoivent	I realize
bientôt	soon
afin	in order
mesures	measures
sécurité	security
levées	lifted
vus	seen
t'ai	you've
l'Éclair	the Flash
feu	fire
ah	ah
triomphant	triumphant
l'avais	had
l'avait	had
ensorcelé	bewitched
remarquer	notice
aïe	ouch
hululait	hululait
allègrement	happily
mordillé	mordillé
doigt	finger
pensait	thought
geste	gesture
d'affection	affection
apporté	brought
commande	command
poste	post
indiqué	indicated
nom	name
l'or	gold
coffre	safety deposit box
numéro	number
711	711
gringotts	gringotts
mien	mine
considère	consider
cadeau	gift
parrain	sponsor
treize	thirteen
ans	years
voudrais	would like to
demander	ask
pardon	forgiveness
frayeur	fright
voulais	wanted
t'apercevoir	you see
continuer	continue
route	road
nord	north
t'envoie	sends you
devrait	should
faciliter	facilitate
écris-moi	write to me
chouette	owl
saura	will
t'écrirai	you will write
s'empressa	hastened
regarder	watch
trouva	found
l'eut	had
parcouru	traveled
éprouva	felt
sensation	sensation
bu	bu
bouteille	bottle
bièraubeurre	bièraubeurre
soussigné	the undersigned
donne	gives
présente	this
l'autorisation	the authorization
filleul	godson
week-end	weekend
suffira	suffice
p	p
-s	-s
garder	keep
puisque	since
rat	rat
écarquilla	écarquilla
continuait	continued
hululer	hululer
ardeur	ardor
creux	hollow
indécis	undecided
examina	examined
attentivement	carefully
moment	time
surprise	surprise
celui-ci	it
flairer	sniff
penses	think
chat	cat
ronronner	purr
ravi	ravi
lut	lut
relut	read
l'arrivée	the arrival
king's	king's
cross	cross
tenait	held
serrée	tight
franchit	crosses
barrière	barrier
quai	dock
9	9
3/4	3/4
repéra	spotted
l'oncle	uncle
vernon	vernon
distance	distance
mrs	mrs
soupçonneux	suspicious
pires	the worst
appréhensions	apprehensions
semblèrent	seemed
confirmées	confirmed
tandis	while
poussait	pushing
chariot	cart
cage	cage
d'hedwige	of hedwig
l'accueillit	the hosted
habituelle	usual
autorisation	authorization
signer	sign
l'interrompit	the interrupted
link	link
to	to
page	page
1	1
10	10
20	20
31	31
45	45
62	62
80	80
92	92
106	106
121	121
139	139
153	153
166	166
177	177
192	192
206	206
218	218
230	230
235	235
248	248
253	253
273	273
286	286
n'as	did
assassin	assassin
condamné	sentenced
perpétuité	life
évadé	escaped
prison	prison
sorciers	wizards
m'écrit	writes to me
prend	takes
heureux	happy
l'expression	the expression
horrifiée	horrified
dirigea	led
poussant	pushing
l'été	the summer
s'annonçait	it announced that
celui	the
matiÈres	materials
2	2
grosse	big
3	3
magicobus	magicobus
4	4
chaudron	cauldron
baveur	leaky
5	5
dÉtraqueur	dÉtraqueur
6	6
coups	shots
griffes	claws
feuilles	leaves
thÉ	tea
7	7
Épouvantard	Épouvantard
penderie	closet
8	8
dame	lady
sinistre	disaster
dÉfaite	defeat
11	11
12	12
13	13
14	14
rancune	grudge
15	15
finale	final
16	16
prÉdiction	prediction
17	17
chien	dog
18	18
19	19
21	21
secret	secret
23	23
l'auteur	the author
j	j
k	k
rowling	rowling
née	born
chipping	chipping
sodbury	sodbury
bristol	bristol
angleterre	england
1965	1965
suivi	follow-up
études	studies
l'université	the university
d'exeter	exeter
paris	paris
diplômée	graduate
langue	language
littérature	literature
françaises	French
d'abord	first
travaillé	worked
londres	london
sein	within
l'association	the association
amnesty	amnesty
international	international
enseigné	taught
français	French
1990	1990
l'idée	the idea
école	school
magiciens	magicians
commencé	started
germer	sprout
esprit	spirit
attendait	waiting
retard	delay
écrire	write
aventures	adventures
l'apprenti	the apprentice
entre-temps	meanwhile
joanne	joanne
partie	part
enseigner	teach
portugal	portugal
épousé	married
journaliste	journalist
portugais	Portuguese
fille	girl
jessica	jessica
divorce	divorce
installée	installed
edimbourg	edinburgh
vivait	lived
situation	situation
précaire	precarious
six	six
consacrée	dedicated
l'écriture	writing
livre	book
ressemble	looks like
conte	tale
fées	fairy
premier	first
agent	agent
auquel	which
manuscrit	manuscript
retint	retained
publication	publication
vendu	sold
enchères	auction
États-unis	United states
avance	advance
versée	paid
auteur	author
jeunesse	youth
volume	volume
rencontré	met
parution	release
succès	success
phénoménal	phenomenal
tant	as
grande-bretagne	great britain
qu'à	as
l'étranger	the foreign
traduit	translated
trente	thirty
langues	languages
millions	million
d'exemplaires	copies
vendus	sold
entier	integer
l'espace	the space
dix-huit	eighteen
remporté	won
prix	price
prestigieux	prestigious
pays	country
publié	published
ventes	sales
adultes	adults
confondus	confused
volumes	volumes
suivants	the following
cessent	stop
quant	as
confirmer	confirm
sept	seven
prévus	provided
desquels	which
fera	will
grandir	grow
évoluer	evolve
mûrir	mature
chacun	each
représente	represents
tenant	taking into
éloignée	remote
médias	media
étourdissant	stunning
consacrer	devote
prisonnier	prisoner
d'azkaban	of azkaban
l'anglaispar	the anglaispar
jean-françois	jean-françois
menard	menard
1hibou	1hibou
2la	2la
3le	3the
4le	4le
5le	5
6coups	6coups
7un	7
8la	8.
9sinistre	9sinistre
10la	10la
11l'eclair	11l'eclair
12le	12-the
13gryffondor	13gryffondor
14la	14.
15la	15o
16la	16la
prÉdilection	favorite
17chat	17chat
18lunard	18lunard
19le	19.
20le	20le
21le	21
22encore	22encore
