4	4
le	the
chaudron	cauldron
baveur	leaky
harry	harry
mit	mit
plusieurs	several
jours	days
à	to
s'habituer	get used
cette	this
étrange	strange
et	and
nouvelle	new
liberté	freedom
jamais	never
auparavant	previously
il	it
n'avait	had
eu	had
la	the
possibilité	possibility
de	of
se	is
lever	sunrise
quand	when
bon	good
lui	him
semblait	seemed
ou	or
manger	eat
ce	this
qui	that
plaisait	liked
pouvait	could
même	even
aller	go
où	where
voulait	wanted
condition	condition
que	that
fût	was
sur	on
chemin	path
traverse	crosses
mais	but
comme	as
longue	long
rue	street
pavée	paved
rassemblait	together
les	the
plus	more
extraordinaires	extraordinary
boutiques	shops
sorcellerie	witchcraft
du	the
monde	world
aucune	no
envie	want
désobéir	disobey
fudge	fudge
en	in
s'aventurant	venturing
dans	in
des	of
moldus	muggle
chaque	each
matin	morning
prenait	took
son	its
petit	small
déjeuner	breakfast
salle	room
plaisir	fun
observer	observe
autres	other
clients	customers
drôles	funny
petites	small
sorcières	witches
débarquées	landed
campagne	campaign
pour	for
faire	do
shopping	shopping
vieux	old
mages	the magi
vénérables	venerable
commentant	commenting on
derniers	last
articles	articles
mensuel	monthly
métamorphose	metamorphosis
sorciers	wizards
hirsutes	shaggy
nains	dwarves
tapageurs	rowdy
un	a
jour	day
quelqu'un	someone
avait	had
l'air	the air
d'une	a
harpie	harpy
commanda	commanded
une	a
assiette	plate
foie	liver
cru	raw
tête	head
dissimulée	concealed
sous	under
passe-montagne	balaclava
après	after
sortait	out
cour	court
derrière	behind
pub	pub
sa	its
baguette	wand
magique	magic
tapotait	tapotait
troisième	third
brique	brick
au-dessus	above
poubelle	trash
partant	hence
gauche	left
attendait	waiting
s'ouvre	opens
porte	door
arcade	arcade
donnait	gave
accès	access
au	the
passait	passed
longues	long
journées	days
ensoleillées	sunny
explorer	explorer
l'ombre	the shadow
parasols	umbrellas
multicolores	multi-coloured
disposés	willing
aux	the
terrasses	terraces
cafés	cafes
montraient	showed
leurs	their
achats	purchases
(	(
c'est	it is
lunascope	lunascope
mon	my
besoin	need
fatiguer	tired
cartes	cards
lune	moon
)	)
commentaient	comment
l'évasion	the escape
sirius	sirius
black	black
personnellement	personally
je	I
ne	do
laisserai	let
enfants	children
sortir	out
seuls	only
tant	as
qu'il	it
sera	will be
pas	not
retourné	returned
azkaban	azkaban
ses	its
devoirs	duties
vacances	holiday
cachette	cache
couverture	coverage
a	has
présent	this
travailler	work
plein	full
terrasse	terrace
florian	florian
fortarôme	fortarôme
glacier	glacier
parfois	sometimes
bénéficiait	enjoyed
l'aide	using
lui-même	himself
savait	knew
beaucoup	a lot
choses	things
chasses	hunts
moyen	average
age	age
sundaes	ice cream sundae
gratuits	free
toutes	all
demi-heures	half-hours
depuis	since
rempli	filled
bourse	stock exchange
gallions	galleons
d'or	gold
mornilles	mornilles
d'argent	money
noises	noises
bronze	bronze
était	was
allé	gone
chercher	search
chambre	room
forte	strong
gringotts	gringotts
devait	should
efforts	efforts
considérables	considerable
tout	all
dépenser	spend
d'un	a
seul	only
coup	blow
encore	yet
cinq	five
années	years
d'études	studies
poudlard	hogwarts
s'imaginait	imagine
demandant	asking
l'argent	the money
dursley	dursley
s'acheter	buy
grimoires	grimoires
aussi	also
avait-il	had he
dû	due
renoncer	waive
magnifique	beautiful
jeu	game
bavboules	bavboules
or	gold
(les	(the
étaient	were
sortes	kinds
billes	ball
sorcier	sorcerer
avaient	had
faculté	faculty
projeter	project
liquide	liquid
pestilentiel	putrid
visage	face
joueur	player
adverse	opposing
lorsqu'elles	when they
perdaient	lost
point)	point)
également	also
terriblement	terribly
tenté	tried
par	by
reproduction	reproduction
parfaite	perfect
galaxie	galaxy
grand	great
globe	globe
verre	glass
l'aurait	would have
dispensé	provided
prendre	take
désormais	now
moindre	less
cours	during
d'astronomie	astronomy
l'objet	the object
exerça	exercised
grande	great
tentation	temptation
apparut	appeared
semaine	week
arrivée	arrival
sens	meaning
l'économie	the economy
fut	was
effet	effect
mis	put
rude	rough
épreuve	test
lorsqu'il	when it
vit	lives
foule	crowd
s'engouffrer	rush
soudain	suddenly
boutique	shop
préférée	favorite
magasin	store
d'accessoires	accessories
quidditch	quidditch
intrigué	intrigued
entra	entered
tour	tour
fraya	fraya
parmi	among
surexcités	excited
jusqu'à	up to
podium	podium
venait	came
d'être	to be
installé	installed
aperçut	saw
alors	then
extraordinaire	extraordinary
balai	broom
eût	had
vu	seen
Ça	It
vient	comes
prototype	prototype
dit	said
côté	side
vrai	true
rapide	fast
papa	dad
demanda	asked
jeune	young
garçon	boy
accroché	hung
bras	arm
père	father
l'équipe	the team
nationale	national
d'irlande	ireland
commander	order
sept	seven
ces	these
merveilles	wonders
joueurs	players
annonça	announced
patron	boss
ils	they
partent	leave
favoris	favorites
coupe	cup
grosse	big
sorcière	witch
tenait	held
devant	before
décida	decided
enfin	finally
bouger	move
put	put
lire	read
l'écriteau	the sign
posé	asked
l'Éclair	the Flash
feu	fire
avec	with
ligne	line
aérodynamique	aerodynamic
manche	sleeve
bois	wood
frêne	ash
recouvert	covered
vernis	varnish
garanti	guaranteed
inattaquable	unassailable
course	race
représente	represents
dernier	last
cri	cry
matière	material
technologie	technology
modèle	model
numéro	number
fabrication	manufacturing
gravé	engraved
main	hand
garantit	guarantees
qualité	quality
branches	branches
bouleau	birch
soigneusement	carefully
sélectionnées	selected
ont	have
été	been
taillées	cut
obtenir	get
meilleur	best
coefficient	coefficient
pénétration	penetration
donnant	giving
équilibre	balance
précision	precision
insurpassables	unsurpassable
accélérations	acceleration
0	0
240	240
km/h	km/h
dix	ten
secondes	seconds
sortilège	hex
freinage	braking
toute	any
offre	offers
meilleures	best
performances	performance
conditions	conditions
sécurité	security
actuellement	currently
disponibles	available
marché	market
prix	price
demande	request
n'osait	did not dare to
songer	consider
quantité	quantity
coûter	cost
telle	such
merveille	wonder
c'était	it was
première	first
fois	time
vie	life
désirait	wanted
quelque	some
chose	thing
autant	as much
d'intensité	intensity
perdu	lost
match	match
nimbus	nimbus
2000	2000
quoi	what
vider	empty
contenu	content
acheter	buy
Éclair	Flash
puisqu'il	since it
possédait	had
déjà	already
excellent	excellent
revint	returned
presque	almost
contempler	contemplate
y	there
d'autres	other
obligé	forced
d'acheter	buy
passa	spent
chez	in
l'apothicaire	the apothecary
renouvela	renewed
stock	stock
d'ingrédients	ingredients
potions	potions
puis	then
acheta	bought
nouvelles	new
robes	dresses
celles	those
l'année	the year
dernière	last
étant	being
trop	too
courtes	short
centimètres	centimeters
important	important
fit	fit
l'acquisition	the acquisition
nouveaux	new
manuels	manuals
notamment	in particular
ceux	those
traitaient	treated
deux	two
matières	materials
étudierait	would consider
année	year
soins	care
créatures	creatures
magiques	magic
divination	divination
eut	had
surprise	surprise
regardant	looking at
vitrine	showcase
libraire	bookseller
lieu	place
l'habituelle	the usual
exhibition	exhibition
taille	size
pavé	pad
incrustée	keyed
lettres	letters
cage	cage
fer	iron
laquelle	which
enfermés	locked
centaine	hundred
d'exemplaires	copies
monstrueux	monstrous
livre	book
monstres	monsters
pages	pages
déchirées	torn
volaient	flew
tous	all
tandis	while
livres	books
livraient	engaged
matchs	games
lutte	fight
s'agrippant	clinging
prises	taken
furieuses	furious
ponctuées	punctuated
féroces	fierce
claquements	clicks
couvertures	blankets
sortit	went out
liste	list
poche	pocket
regarda	looked at
détail	detail
manuel	manual
base	base
comprenait	included
pourquoi	why
hagrid	hagrid
offert	offered
anniversaire	anniversary
sentit	felt
soulagé	relieved
craint	fears
ait	has
adopté	adopted
animal	animal
terrifiant	terrifying
d'aide	help
maîtriser	master
lorsque	when
librairie	library
fleury	fleury
bott	bott
directeur	director
précipita	rushed
vers	to
Élève	Student
dit-il	he said
brûle-pourpoint	point blank
vous	you
êtes	are
venu	come
vos	your
oui	yes
j'ai	I
Écartez-vous	Out, you
ton	your
impatient	looking forward
repoussant	pushing
paire	pair
gants	gloves
épais	thick
saisit	captures
canne	cane
noueuse	nodosa
s'avança	advanced
peine	penalty
j'en	I
ai	I
vraiment	really
exprima	expressed
profond	deep
soulagement	relief
bonne	good
me	me
suis	am
fait	fact
mordre	bite
bruit	noise
déchirure	tear
retentit	sounds
attrapé	caught
s'acharnaient	were baited
mettre	put
pièces	parts
arrêtez	stop
s'écria	cried
leur	their
grands	great
coups	shots
travers	through
barreaux	bars
horreurs	horrors
entrer	enter
ma	my
devenu	now
maison	home
fous	crazy
croyais	thought
n'y	there
aurait	would
rien	nothing
pire	worst
on	it
acheté	bought
cents	cents
exemplaires	best
invisible	invisible
l'invisibilité	the invisibility
–	-
nous	we
coûté	cost
fortune	fortune
retrouvés	found
qu'est-ce	what is this
auriez	would
voulu	wanted
j'aurais	I would have
cassandra	cassandra
vablatsky	vablatsky
intitulé	title
voile	sailing
futur	future
œil	eye
ah	ah
allez	go
étudier	study
conduisant	leading
fond	background
coin	corner
consacré	dedicated
voyance	clairvoyance
petite	small
table	table
croulait	was sinking
ouvrages	books
genre	kind
prédire	predict
l'imprévisible	the unpredictable
protégez-vous	protect yourself
contre	against
chocs	shocks
cristal	crystal
brisé	broken
mauvais	bad
sort	fate
monta	went up
escabeau	stepladder
tendit	handed
gros	wholesale
volume	volume
relié	connected
noir	black
guide	guide
d'initiation	initiation
principales	the main
méthodes	methods
chiromancie	palmistry
boule	ball
marc	marc
café	coffee
n'écoutait	not listened to
regard	look
tombé	fallen
autre	other
exposé	presentation
milieu	middle
présages	omens
mort	death
l'on	we
sent	feels
venir	come
si	if
j'étais	I was
lirais	read
ça	it
léger	lightweight
sinon	otherwise
commencer	start
voir	see
partout	everywhere
finirez	'll end up
mourir	die
peur	fear
continuait	continued
regarder	watch
fixement	staring
elle	it
représentait	represented
chien	dog
ours	bear
yeux	eyes
flamboyants	flamboyant
d'étrangement	strangely
familier	familiar
entre	between
mains	hands
exemplaire	copy
faut	must
demanda-t-il	he asked
répondit	replied
arrachant	snatching
l'image	the image
consulter	consult
air	air
absent	absent
heu	uh
faudrait	should
sorts	spells
enchantements	enchantments
niveau	level
3	3
minutes	minutes
tard	later
retourna	returned
marchait	walked
droit	right
sans	without
très	very
attention	attention
mettait	put
pieds	feet
bouscula	pushed
personnes	people
passage	passage
lourd	heavy
marches	steps
l'escalier	the stairs
jeta	threw
lit	bed
ménage	household
fenêtres	windows
ouvertes	open
soleil	sun
inondait	flooded
pièce	room
entendait	heard
autobus	bus
roulaient	rolled
mêlé	mixed
rumeur	rumor
pressait	pressed
reflet	reflection
miroir	mirror
lavabo	sink
être	be
présage	omen
image	image
défi	challenge
pris	taken
panique	panic
magnolia	magnolia
crescent	crescent
doute	doubt
simple	simple
errant	wandering
leva	rose
machinalement	going through the motions
essaya	tried
d'aplatir	flatten
cheveux	hair
combat	combat
d'avance	advance
voix	voice
sifflante	wheezing
mesure	measurement
passaient	passed
essayait	tried
repérer	identify
ron	ron
hermione	hermione
voyait	saw
nombreux	many
élèves	students
rencontra	met
seamus	seamus
finnigan	finnigan
dean	dean
thomas	thomas
camarades	comrades
classe	class
gryffondor	gryffindor
eux	them
regardaient	watched
ronds	round
véritable	true
neville	neville
londubat	londubat
distrait	distracted
lunaire	lunar
s'arrêta	stopped
bavarder	chat
faisait	was
réprimander	reprimand
bruyamment	loudly
redoutable	formidable
grand-mère	grand-mother
espérait	hoped
bien	well
qu'elle	it
n'apprendrait	there would learn
s'était	had
passer	pass
petit-fils	grandson
magicobus	magicobus
réveilla	woke up
pensant	thinking
qu'au	that
moins	less
sûr	course
revoir	review
lendemain	next day
bord	edge
express	express
s'habilla	dressed
alla	alla
jeter	throw
d'œil	eye
s'apprêtait	was about
cria	cried
nom	name
là	there
assis	sitting
faisaient	were
signes	signs
arborait	sported
bronzage	tanning
impressionnant	awesome
avoir	have
taches	spots
rousseur	freckles
large	wide
sourire	smile
s'asseyait	sat
est	is
allés	went
te	te
tu	you
étais	was
parti	party
mes	my
fournitures	supplies
expliqua	explained
comment	how
avez-vous	have you
su	su
simplement	simply
mr	mr
weasley	weasley
travaillait	worked
ministère	department
magie	magic
courant	current
l'histoire	the story
compris	including
arrivé	arrived
tante	aunt
marge	margin
as	as
gonflé	inflated
ta	your
ballon	ball
grave	serious
l'ai	I
exprès	express
assura	assura
pendant	during
éclatait	broke out
rire	laugh
sang-froid	in cold blood
n'est	there is
drôle	funny
sèchement	curtly
honnêtement	honestly
stupéfaite	stunned
n'ait	did
renvoyé	returned
moi	me
admit	admitted
m'attendais	was expecting
arrêter	stop
sait	knows
fermé	closed
ajouta-t-il	he added
tournant	turning
parce	because
toi	you
riait	laughed
toujours	always
célèbre	famous
potter	potter
préfère	prefer
savoir	know
ferait	would
m'amusais	fun
gonfler	inflate
tantes	aunts
remarque	note
d'abord	first
qu'ils	they
déterrent	dig up
mère	mother
m'aurait	I would have
tué	killed
sur-	on-
le-champ	the-field
n'as	did
qu'à	as
demander	ask
soir	evening
va	will
nuit	night
pourras	can
gare	station
demain	tomorrow
reste	rest
rayonnant	radiant
approuva	approved
signe	sign
parents	parents
m'ont	I have
laissée	left
ici	here
affaires	business
formidable	great
s'exclama	exclaimed
joyeux	happy
avez	have
manque	lack
regarde	look at
sortant	outgoing
boîte	box
ouvrit	opened
délicatement	gently
neuve	new
trente-cinq	thirty-five
long	long
saule	willow
crin	horsehair
queue	tail
licorne	unicorn
l'intérieur	inside
nos	our
montrant	showing
sac	bag
chaise	chair
peu	little
failli	bankrupt
fondre	melt
larmes	tears
fallait	had to
trois	three
énormes	huge
sacs	bags
posés	posed
autour	around
d'hermione	of hermione
davantage	more
d'options	options
expliqua-t-elle	explained it
sont	are
d'arithmancie	of arithmancie
d'étude	study
runes	runes
s'étonna	was surprised
lançant	launching
effaré	aghast
es	es
née	born
famille	family
tes	your
sais	know
passionne	passionate about
point	point
vue	view
sérieux	serious
est-ce	is this
l'intention	the intention
dormir	sleep
goguenard	bantering
semblant	pretend
entendu	heard
dit-elle	she said
septembre	September
donné	given
m'acheter	buy me
cadeau	gift
pourrais	could
t'offrir	offer you
exemple	example
lança	launched
faussement	false
naïf	naive
non	not
crois	believe
hibou	owl
hedwige	hedwig
errol	errol
n'ai	haven
coupa	cut
croûtard	croûtard
rat	rat
fasse	do
examiner	review
posant	posing
l'animal	the animal
l'egypte	egypt
maigre	lean
l'ordinaire	the ordinary
moustaches	whiskers
tombaient	fell
tristement	sadly
là-bas	there
connaissait	knew
cœur	heart
s'ils	if they
remède	remedy
pourra	may
payèrent	paid
glaces	ice
traversèrent	crossed
ménagerie	menagerie
n'était	there was
murs	walls
entièrement	fully
recouverts	covered
cages	cages
régnait	reigned
vacarme	din
permanent	permanent
accompagné	accompanied
odeur	smell
occupaient	occupied
temps	time
piailler	squeak
couiner	the whining
caqueter	cackle
siffler	whistle
comptoir	counter
conseils	tips
client	client
prodiguer	provide
tritons	newts
double	double
examinèrent	reviewed
enfermées	locked
crapauds	toads
violets	purple
gobaient	gobaient
cadavres	corpses
mouches	flies
viande	meat
émettant	emitting
bruits	noise
succion	sucking
tortue	turtle
géante	giant
carapace	shell
pierres	stones
précieuses	precious
étincelait	sparkled
près	near
escargots	snails
venimeux	venomous
couleur	color
orange	orange
rampaient	crawling
lentement	slowly
parois	walls
lièvre	hare
blanc	white
métamorphosait	could turn
cesse	stops
chapeau	hat
haut	top
forme	form
pétard	firecracker
chats	cats
couleurs	colors
pleine	full
corbeaux	ravens
jacasseurs	jacasseurs
panier	basket
fourrure	fur
chantonnaient	chantonnaient
remplie	filled
rats	rats
noirs	black
sautaient	jumping
corde	rope
servant	serving
queues	tails
triton	triton
s'approcha	approached
ennuis	trouble
patraque	woozy
qu'on	we
egypte	egypt
mettez-le-moi	put me
grosses	large
lunettes	glasses
noires	black
extirpa	pulled out
déposa	filed
congénères	congeners
cessèrent	ceased
aussitôt	as soon
jeux	games
précipitèrent	ran
l'avait	had
hérité	inherited
frères	brothers
(il	(it
appartenu	belonged
percy)	percy)
reluisant	shiny!
poil	hair
soyeux	silky
rassemblés	gathered
particulièrement	particularly
pitoyable	pitiful
mmhhh	mmhhh
grommela	grumbled
quel	what
âge	age
avant	before
appartenait	belonged
frère	brother
pouvoirs	powers
examinant	examining
hein	eh
vérité	truth
manifesté	shown
don	gift
soit	either
regardèrent	looked
l'oreille	the ear
lambeaux	shreds
patte	paw
amputée	amputated
doigt	finger
bout	end
rouleau	roll
hochant	nodding
percy	percy
l'a	the
défendre	defend
ordinaire	ordinary
celui-là	this one
rarement	rarely
ans	years
cherchez	looking for
résistant	resistant
pourriez	could
peut-être	maybe
essayer	try
ceux-	those
ci	it
montra	showed
recommencèrent	started
sauter	jump
cabotins	cabotins
marmonna	muttered
n'en	do
voulez	want to
d'autre	on the other
essayez	try
ratconfortant	ratconfortant
tonique	tonic
ratbougris	ratbougris
prenant	taking
flacon	bottle
rouge	red
d'accord	agreement
combien	how
ouille	ouch
plia	folded
levées	lifted
protéger	protect
énorme	huge
élancée	slender
haute	high
atterri	landed
rebondi	bounced
précipitant	precipitating
sifflements	whistling
furieux	furious
suffit	just
pattenrond	pattenrond
glissé	slipped
savon	soap
atterrit	lands
sol	soil
pattes	legs
écartées	apart
s'enfuit	fled
poursuite	further
suivit	followed
fallut	took
dizaine	ten
retrouver	find
réfugier	refuge
proximité	close
remit	gave
tremblant	tremblant
redressa	straightened
massant	massaging
truc	trick
m'est	I
crâne	skull
chat	cat
tigre	tiger
suggéra	suggested
train	train
revinrent	returned
lorsqu'ils	when they
furent	were
retour	return
serrait	tightened
l'énorme	the huge
dis	say
monstre	monster
bouche	mouth
bée	eer
trouves	find
rayonnante	radiant
question	question
goût	taste
pensa	thought
orangée	orange
épaisse	thick
foisonnante	abounding
nettement	clearly
arquées	arching
museau	muzzle
étrangement	strangely
écrasé	crushed
s'il	if it
heurté	hit
mur	wall
fouet	whip
grincheux	grumpy
disparu	gone
champ	field
vision	vision
ronronnait	hummed
paisiblement	peacefully
m'a	me
quasiment	almost
scalpé	scalped
protesta	protested
n'est-ce	is this
s'indigna	grew indignant
bosse	kicker
formait	formed
repos	rest
tranquillité	peace
n'aura	will
paix	peace
machin-là	machin-
penser	think
avais	had
oublié	forgot
glissant	sliding
souci	concern
dormira	sleep
dortoir	dormitory
filles	girls
celui	the
garçons	boys
vois	see
problème	problem
pauvre	poor
resté	stayed
éternité	eternity
personne	person
sarcastique	sarcastic
prenaient	took
direction	management
bar	bar
lisait	read
gazette	gazette
lança-t-il	"he shouted,
vas-tu	are you going to
merci	thank you
suivi	follow-up
rejoignit	joined
journal	journal
s'étalait	spread
nouveau	new
photo	photo
regardait	watched
l'ont	have
soudaine	sudden
gravité	gravity
avons	have
mobilisés	mobilized
échoué	failed
toucherait	would
récompense	reward
l'attrapait	length
serait	would be
ramasser	pick up
sois	am
ridicule	ridiculous
répliqua	replied
paraissait	seemed
tendu	tense
laisser	let
treize	thirteen
gardiens	guards
d'azkaban	of azkaban
puissent	can
capturer	capture
peux	can
croire	believe
cet	this
instant	now
mrs	mrs
entrée	entry
chargée	responsible
suivie	followed
fils	son
jumeaux	twins
fred	fred
george	george
allaient	would
cinquième	fifth
préfet-en-chef	prefect-in-chief
ginny	ginny
benjamine	benjamine
faible	low
sembla	seemed
gênée	embarrassed
lorsqu'elle	when it
l'aperçut	the saw
sauvé	saved
précédente	previous
rougit	blushes
jusqu'aux	up to
oreilles	ears
vague	wave
salut	hi
revanche	contrast
solennel	solemn
rencontraient	met
heureux	happy
s'efforçant	striving
éclater	burst
j'espère	I hope
vas	vas
ajouta	added
pompeusement	pompously
serrant	tightening
l'impression	printing
participer	participate
cérémonie	ceremony
officielle	official
assura-t-il	assured-t-he
écartant	apart
coude	elbow
s'inclinant	bowing
profondément	deeply
fabuleux	fabulous
poussant	pushing
absolument	absolutely
épatant	amazing
fronça	frowned
sourcils	eyebrows
maintenant	now
maman	mom
juste	just
s'apercevoir	see
présence	presence
renversant	reversing
répéta	repeated
vide	empty
bonjour	hello
chéri	darling
j'imagine	I guess
connais	know
l'insigne	the badge
argent	money
flambant	brand
neuf	nine
poitrine	chest
deuxième	second
orgueil	pride
souffle	breath
reprit	took
fronçant	frowned
remarqué	noticed
qu'aucun	no
n'a	did
nommé	named
préfet	prefect
l'idée	the idea
révolter	rebel
donner	give
sœur	sister
peuvent	can
servir	serve
d'exemple	for example
supérieur	higher
vais	'll
changer	change
dîner	dinner
s'éloigna	walked away
poussa	pushed
soupir	sigh
essayé	tried
l'enfermer	the lock
pyramide	pyramid
vus	seen
soir-là	evening
agréable	nice
tom	tom
disposé	willing
tables	tables
côte	coast
salon	living room
servit	served
plats	dishes
délicieux	delicious
accompagnée	accompanied
entamaient	started
somptueux	sumptuous
gâteau	cake
chocolat	chocolate
envoyer	send
voitures	cars
tourna	turned
cause	cause
perce	bore
sérieusement	seriously
vont	go
petits	small
drapeaux	flags
capot	hood
p-e-c	p-e-c
brodées	embroidered
dessus	top
veut	wants to
dire	say
prétentieux-et-crâneur	pretentious-and-crâneur
pouffa	pouffa
sauf	except
envoie-t-il	does he send
cérémonieuse	formal
eh	eh
travaille	works
décidé	decided
fleur	flower
cela	this
détaché	detached
remarqua	noticed
devenues	become
écarlates	scarlet
l'aise	comfortable
heureusement	fortunately
intervint	intervened
rends	give
compte	account
bagages	luggage
offririez	would
beau	beautiful
spectacle	show
métro	metro
valises	suitcases
prêtes	ready
rangé	tidy
sienne	siena
douloureux	painful
entassé	piled
ferais	would
t'en	you
occuper	care
n'aurons	will not
fin	end
l'estomac	the stomach
sentait	felt
endormi	asleep
convives	guests
montèrent	went up
préparer	prepare
voisine	nearby
celle	the
celui-ci	it
boucler	loop
valise	suitcase
entendit	heard
éclats	shards
l'autre	the other
couloir	hallway
12	12
entrouverte	ajar
chevet	bedside
hurlait-il	screaming-it
l'avais	had
enlevé	removed
l'astiquer	Polish
touché	hit
passe	pass
insigne	badge
fouillant	searching
d'ici	here
retrouvé	found
fini	finished
médicament	medicine
échos	echoes
dispute	dispute
provenance	from
reconnut	recognized
hésita	hesitated
discret	discreet
possible	possible
prononcer	pronounce
propre	own
curiosité	curiosity
l'emporta	took it to
absurde	absurd
s'exclamait	exclaimed
d'en	to
parler	talk
entendre	hear
persiste	persists
traiter	treat
gamin	kid
pourtant	yet
arthur	arthur
l'interrompit	the interrupted
perçante	piercing
terrifié	terrified
apprenait	learned
veux	want to
retourne	returns
menace	threat
laisse-le	let the
donc	so
tranquille	quiet
sachant	knowing
démoraliser	demoralize
gardes	guards
promener	walk
forêt	forest
interdite	prohibited
surtout	especially
recommence	again
fantaisie	fantasy
pense	think
pu	could
arriver	getting
s'est	is
enfui	away
ramassé	picked up
retrouve	found
justement	precisely
santé	health
molly	molly
fou	crazy
suffisamment	enough
intelligent	smart
s'évader	escape
qu'en	in
principe	principle
impossible	impossible
semaines	weeks
fuite	leak
trace	trace
peut	can
d'attraper	to catch
d'inventer	to invent
baguettes	chopsticks
automatiques	automatic
seule	only
certaine	some
intentions	intentions
parfaitement	perfectly
pensait	thought
prison	prison
offrait	offered
réussi	successful
s'en	in
échapper	escape
s'introduire	enter
veuille	want to
sourd	deaf
taper	type
poing	fist
faudra-t-il	will there be a
répète	repeat
parlé	spoken
presse	press
sache	know
rendu	rendering
évadé	escaped
certain	some
parlait	spoke
sommeil	sleep
répétait	repeated
l'esprit	the spirit
dérangé	disturbed
tuer	kill
avis	notice
doit	must
persuadé	persuaded
permettrait	would
ramener	bring
tu-sais-qui	you-know-who
pouvoir	power
terme	term
agissements	actions
ruminer	mull over
douze	twelve
passés	past
silence	silence
pencha	bent
avide	greedy
utile	useful
oublies	forget
albus	albus
dumbledore	dumbledore
puisse	can
fallu	had to
l'autorisation	the authorization
poster	post
différentes	different
entrées	entries
l'école	the school
content	content
accepté	accepted
serait-il	would it be
mécontent	unhappy
parviennent	manage
n'aime	likes
d'ailleurs	moreover,
affaire	case
tel	such
gens	people
préférerait	would prefer
éviter	avoid
arrivent	arrive
sauver	save
cas	case
dirai	tell
las	las
d'aller	go
coucher	bedroom
chaises	chairs
fila	fila
s'ouvrit	opened
indiquèrent	indicated
montaient	rose
bouteille	bottle
trouvait	was
s'étaient	had
l'après-midi	in the afternoon
attendit	waited
refermée	closed
accroupis	squatting
pénombre	penumbra
retenaient	holding
écoutant	listening to
fouiller	search
l'avons	have
chuchota	whispered
arrangé	arranged
roquet-en-chef	pug-in-chief
força	forced
s'enferma	began
s'allongea	lain
ainsi	as well
cherchait	was looking for
s'expliquait	was
montré	shown
indulgent	forgiving
envers	to
vivant	living
promettre	promise
rester	stay
veiller	ensure
allait	would
officielles	official
emmèneraient	emmèneraient
surveiller	monitor
monte	monte
resta	remained
immobile	still
écouter	listen
cris	cree
étouffés	muffled
provenaient	came
n'aurait	would
persuadés	believe
saisi	seized
apprendre	learn
affirmait	said
d'endroit	place
disait-on	it was said
craignait	feared
lord	lord
voldemort	voldemort
n'aurait-	would
dont	which
cessait	stopped
semblaient	seemed to
inspirer	inspire
terreur	terror
postés	posted
mal	evil
finalement	finally
préoccupait	concern
pratiquement	virtually
chance	chance
d'obtenir	to obtain
visiter	visit
pré-au-lard	pre-to-bacon
laisserait	leave
quitter	leave
périmètre	perimeter
protégé	protected
château	castle
rattrapé	caught up
s'attendait	expected
surveillance	monitoring
instants	moments
danger	danger
écarté	rejected
contemplant	contemplating
plafond	ceiling
plongé	immersed
pensaient-ils	they thought
incapable	unable
débrouiller	manage
échappé	escaped
griffes	claws
empoté	potted
bête	beast
tapie	tapie
l'obscurité	the dark
s'imposa	set
esprit	spirit
assassiner	murder
état	state
d'esprit	of mind
cher	dear
ami	friend
endormie	sleepy
