chapitre	chapter
8	8
le	the
maître	master
des	of
potions	potions
là	there
regarde	look at
où	where
a	has
côté	side
du	the
grand	great
type	type
roux	roux
avec	with
les	the
lunettes	glasses
tu	you
as	as
vu	seen
sa	its
cicatrice	scar
lendemain	next day
dès	as soon
qu'il	it
eut	had
quitté	left
dortoir	dormitory
harry	harry
entendait	heard
murmurer	whisper
sur	on
son	its
passage	passage
élèves	students
qui	that
attendaient	waiting
à	to
la	the
porte	door
salles	rooms
de	of
classe	class
se	is
levaient	rose
pointe	tip
pieds	feet
pour	for
voir	see
ou	or
revenaient	returned
leurs	their
pas	not
croiser	cross
nouveau	new
pendant	during
ce	this
temps	time
essayait	tried
trouver	find
chemin	path
dans	in
labyrinthe	maze
château	castle
il	it
y	there
avait	had
cent	cent
quarante-deux	forty-two
escaliers	stairs
poudlard	hogwarts
larges	large
étroits	close
courbes	curves
carrés	square
délabrés	dilapidated
certains	some
une	a
deux	two
marches	steps
escamotables	retractable
fallait	had to
souvenir	remember
d'enjamber	step-over
ne	do
tomber	fall
aussi	also
portes	doors
refusaient	refused
s'ouvrir	open
si	if
on	it
leur	their
demandait	asked
poliment	politely
chatouillait	tickled
au	the
bon	good
endroit	place
et	and
d'autres	other
n'étaient	there were
que	that
pans	pans
mur	wall
déguisés	disguised
en	in
était	was
très	very
difficile	difficult
choses	things
trouvaient	were
car	because
tout	all
bougeait	moved
sans	without
cesse	stops
gens	people
représentés	represented
tableaux	tables
accrochés	hung
aux	the
murs	walls
passaient	passed
rendre	make
visite	visit
uns	each
autres	other
persuadé	persuaded
armures	armor
promenaient	walking
parfois	sometimes
couloirs	corridors
quant	as
fantômes	ghosts
ils	they
facilitaient	facilitated
tâche	task
c'était	it was
toujours	always
un	a
choc	shock
désagréable	unpleasant
lorsque	when
l'un	one
d'eux	of them
traversait	crossed
moment	time
l'ouvrir	the open
quasi-sans-tête	quasi-without-head
heureux	happy
d'aider	help
nouveaux	new
gryffondor	gryffindor
mais	but
peeves	peeves
l'esprit	the spirit
frappeur	batting
bombardait	bombarded
morceaux	pieces
craie	chalk
tirait	drew
tapis	carpet
sous	under
renversait	reversed
corbeilles	baskets
papier	paper
tête	head
glissait	glided
silencieusement	silently
derrière	behind
eux	them
attrapait	caught
nez	nose
hurlant	screaming
je	I
t'ai	you've
eu	had
d'une	a
voix	voice
perçante	piercing
pire	worst
encore	yet
toutefois	however
possible	possible
argus	argus
rusard	rusard
concierge	concierge
ron	ron
avaient	had
réussi	successful
mettre	put
dos	back
premier	first
jour	day
surpris	surprised
alors	then
qu'ils	they
essayaient	tried
d'ouvrir	open
par	by
malchance	bad luck
s'était	had
révélée	revealed
être	be
l'entrée	the entry
couloir	hallway
interdit	prohibited
deuxième	second
étage	floor
refusé	refused
croire	believe
lorsqu'ils	when they
lui	him
expliqué	explained
s'étaient	had
perdus	lost
convaincu	convinced
tenté	tried
forcer	force
exprès	express
menacés	threatened
enfermer	lock
cachot	dungeon
heureusement	fortunately
professeur	professor
quirrell	quirrell
passait	passed
venu	come
secours	relief
chatte	pussy
s'appelait	called
miss	miss
teigne	ringworm
créature	creature
grisâtre	greyish
décharnée	gaunt
yeux	eyes
globuleux	globose
brillaient	shone
comme	as
lampes	lamps
l'image	the image
ceux	those
elle	it
sillonnait	crisscrossed
toute	any
seule	only
qu'elle	it
voyait	saw
quelqu'un	someone
commettre	commit
moindre	less
faute	fault
serait-ce	would it be
poser	ask
orteil	toe
au-delà	beyond
ligne	line
interdite	prohibited
filait	spinning
prévenir	prevent
accourait	hasten to
aussitôt	as soon
soufflant	blowing
bœuf	beef
connaissait	knew
passages	passages
secrets	secrets
l'école	the school
mieux	better
personne	person
(à	(
part	share
peut-être	maybe
jumeaux	twins
weasley)	weasley)
pouvait	could
apparaître	appear
soudainement	suddenly
tous	all
détestaient	hated
nombre	number
d'entre	of
auraient	would
été	been
ravis	happy
donner	give
coup	blow
pied	foot
lorsqu'on	when
enfin	finally
salle	room
arriver	getting
suivre	follow
cours	during
découvrit	discovered
vite	fast
l'exercice	the year
magie	magic
consistait	was
seulement	only
brandir	brandish
baguette	wand
magique	magic
marmonnant	mumbling
quelques	a few
paroles	lyrics
peu	little
bizarres	weird
chaque	each
mercredi	Wednesday
soir	evening
observaient	watched
ciel	sky
télescope	telescope
apprenaient	learning
noms	names
étoiles	star
ainsi	as well
mouvement	movement
planètes	planets
trois	three
fois	time
semaine	week
étudiaient	studying
plantes	plants
serres	greenhouses
situées	located
l'arrière	the rear
direction	management
petite	small
sorcière	witch
joliment	nicely
potelée	chubby
chourave	chourave
plus	more
ennuyeux	boring
étaient	were
d'histoire	history
enseignée	taught
seul	only
fantôme	ghost
collège	college
déjà	already
vieux	old
binns	binns
endormi	asleep
devant	before
cheminée	fireplace
quand	when
levé	survey
matin	morning
aller	go
faire	do
laissé	left
corps	body
parlait	spoke
monocorde	monotonous
tandis	while
griffonnaient	griffonnaient
sorciers	wizards
célèbres	famous
confondant	confusing
emerie	emerie
hargneux	surly
ulric	ulric
follingue	follingue
flitwick	flitwick
d'enchantements	enchantments
minuscule	tiny
sorcier	sorcerer
devait	should
monter	mount
pile	battery
livres	books
par-dessus	above
bureau	office
début	beginning
faisait	was
l'appel	the call
poussa	pushed
petit	small
cri	cry
aigu	acute
voyant	light
nom	name
tomba	fell
renverse	reverses
mcgonagall	mcgonagall
différente	different
juste	just
pensant	thinking
valait	worth
éviter	avoid
contrarier	upset
stricte	strict
intelligente	smart
parla	spoke
directement	directly
métamorphose	metamorphosis
est	is
formes	forms
dangereuses	dangerous
complexes	complex
vous	you
aurez	will
étudier	study
avait-elle	had she
dit	said
quiconque	anyone
fera	will
chahut	ruckus
mes	my
sera	will be
immédiatement	immediately
renvoyé	returned
interdiction	ban
revenir	return
êtes	are
prévenus	defendants
changé	changed
cochon	pig
puis	then
redonné	given
forme	form
d'origine	original
démonstration	demonstration
impressionnante	impressive
hâte	looking forward
commencer	start
bientôt	soon
rendu	rendering
compte	account
près	near
d'en	to
autant	as much
après	after
avoir	have
suivi	follow-up
explications	explanations
compliquées	complicated
commencé	started
s'exercer	exercise
essayant	trying
changer	change
allumette	match
aiguille	needle
hermione	hermione
granger	granger
obtenu	obtained
résultat	result
montré	shown
l'allumette	the match
pris	taken
couleur	color
argentée	silver
dont	which
l'extrémité	the end
devenue	become
pointue	sharp
même	even
accordé	granted
ses	its
rares	rare
sourires	smiles
monde	world
attendait	waiting
impatience	impatience
celui	the
défense	defence
contre	against
forces	forces
mal	evil
l'enseignement	education
tournait	turned
plutôt	rather
farce	stuffing
imprégnée	impregnated
forte	strong
odeur	smell
d'ail	garlic
destiné	for
éloigner	away
vampire	vampire
rencontré	met
roumanie	romania
craignait	feared
turban	turban
avait-il	had he
offert	offered
prince	prince
africain	african
remercier	thank
l'avoir	have
débarrassé	free
d'un	a
zombie	zombie
histoire	history
sonnait	sounded
faux	false
effet	effect
incapable	unable
raconter	tell
comment	how
combattu	fought
dégageait	radiated
fait	fact
dire	say
weasley	weasley
l'avait	had
rempli	filled
protéger	protect
permanence	permanently
vampires	vampires
constata	found
soulagement	relief
n'avait	had
guère	little
retard	delay
camarades	comrades
également	also
élevés	high
familles	families
moldus	muggle
jamais	never
doutés	guessed
appartenaient	belonged
sorcellerie	witchcraft
tant	as
apprendre	learn
avantage	advantage
appartenance	membership
vieille	old
famille	family
vendredi	Friday
trouvé	found
seuls	only
grande	great
servi	served
déjeuner	breakfast
qu'est-ce	what is this
qu'on	we
aujourd'hui	today
demanda	asked
commun	common
magiques	magic
serpentard	slytherin
c'est	it is
rogue	rogue
directeur	director
essaye	try
avantager	benefit
verra	see
bien	well
vrai	true
j'aimerais	I would like to
ait	has
envie	want
nous	we
directrice	director
empêchée	prevented
montagne	mountain
devoirs	duties
courrier	mail
arriva	came to pass
habitué	used
entrer	enter
centaine	hundred
hiboux	owls
tournoyaient	whirled
au-	at-
dessus	top
tables	tables
laissant	leaving
lettres	letters
paquets	packages
genoux	knees
propriétaire	owner
jusqu'à	up to
présent	this
hedwige	hedwig
rien	nothing
apporté	brought
venait	came
mordiller	chew
l'oreille	the ear
grignoter	nibble
morceau	song
toast	toast
avant	before
retourner	return
volière	aviary
réservée	reserved
matin-là	morning
cependant	however
vint	came
voleter	fly
entre	between
confiture	jam
sucrier	sugar
déposa	filed
lettre	letter
l'assiette	the plate
déchira	rent
l'enveloppe	the envelope
sortit	went out
mot	word
griffonné	scribbled
cher	dear
sais	know
es	es
libre	free
après-midi	afternoon
est-ce	is this
aurais	would have
venir	come
prendre	take
tasse	cup
thé	tea
moi	me
alentours	around
heures	hours
voudrais	would like to
savoir	know
s'est	is
passée	past
ta	your
première	first
réponds-moi	answer me
m'envoyant	sending me
hagrid	hagrid
emprunta	borrowed
plume	pen
écrivit	wrote
rapidement	quickly
d'accord	agreement
l'heure	the time
confia	entrusted
message	message
l'emporta	took it to
vers	to
destinataire	recipient
perspective	perspective
mit	mit
baume	balm
cœur	heart
fut	was
nul	no
doute	doubt
épreuve	test
subir	undergo
depuis	since
arrivée	arrival
lors	when
banquet	banquet
d'année	of the year
senti	felt
l'aimait	loved it
beaucoup	a lot
fin	end
rendit	made
trompé	wrong
réalité	reality
haïssait	hated
lieu	place
cachots	dungeons
froid	cold
reste	rest
animaux	animals
flottaient	floating
bocaux	jars
formol	formalin
alignés	aligned
long	long
rendaient	made
l'endroit	the place
effrayant	scary
commença	started
lorsqu'il	when it
arrivé	arrived
marqua	marked
pause	break
ah	ah
oui	yes
dit-il	he said
potter	potter
notre	our
nouvelle	new
célébrité	celebrity
drago	drago
malefoy	malfoy
amis	friends
crabbe	crabbe
goyle	goyle
ricanèrent	ricanèrent
cachant	hiding
mains	hands
acheva	completed
releva	rose
noirs	black
n'avaient	had
chaleur	heat
vides	empty
froids	cold
tunnel	tunnel
ici	here
science	science
subtile	subtle
l'art	the art
rigoureux	rigorous
préparation	preparation
peine	penalty
élevée	high
qu'un	a
murmure	whisper
distinctement	distinctly
don	gift
maintenir	maintain
effort	effort
silence	silence
s'amuse	fun
agiter	shake
baguettes	chopsticks
m'attends	expect
donc	so
compreniez	to understand
grand-chose	much
beauté	beauty
chaudron	cauldron
bouillonne	bubbles
doucement	gently
échapper	escape
volutes	volutes
scintillantes	sparkling
ni	or
délicatesse	delicacy
liquide	liquid
s'insinue	creeps
veines	veins
homme	man
ensorceler	bewitch
esprit	spirit
emprisonner	imprison
sens	meaning
pourrais	could
gloire	glory
bouteille	bottle
distiller	distiller
grandeur	size
mort	death
flacon	bottle
étiez	were
autre	other
chose	thing
qu'une	a
ces	these
bandes	bands
cornichons	pickles
dispense	exemption
habituellement	usually
cette	this
entrée	entry
matière	material
suivie	followed
échangèrent	exchanged
regard	look
levant	rising
sourcils	eyebrows
assise	sitting
bord	edge
chaise	chair
visiblement	obviously
prouver	prove
cornichon	pickle
soudain	suddenly
j'obtiens	I get
j'ajoute	I add
racine	root
d'asphodèle	asphodel
poudre	powder
infusion	infusion
d'armoise	wormwood
quoi	what
jeta	threw
d'œil	eye
parut	appeared
décontenancé	taken aback
main	hand
d'hermione	of hermione
levée	lifting
vitesse	speed
boulet	boulet
canon	canon
monsieur	mr.
répondit	replied
rictus	grin
méprisant	despising
apparemment	apparently
n'est	there is
vie	life
prêter	pay
attention	attention
essayons	try
reprit	took
iriez-vous	would you go
demandais	wondering
me	me
rapporter	report
bézoard	bézoard
leva	rose
toucher	touch
plafond	ceiling
idée	idea
essaya	tried
regarder	watch
secoués	shaken
fou	crazy
rire	laugh
n'alliez	go
vos	your
d'arriver	to arrive
n'est-ce	is this
força	forced
baisser	lower
glacé	glossy
bel	beautiful
ouvert	open
chez	in
dursley	dursley
exiger	require
retenu	retained
contenait	contained
manuel	manual
intitulé	title
mille	thousand
herbes	herbs
champignons	mushrooms
frémissante	simmering
quelle	what
différence	difference
napel	napel
tue-loup	tue-loup
tendue	tense
au-dessus	above
calme	quiet
crois	believe
qu'hermione	as hermione
sait	knows
chance	chance
rires	laughter
revanche	contrast
l'air	the air
content	content
asseyez-vous	sit
lança-t-il	"he shouted,
votre	your
information	information
sachez	be aware
mélange	mix
donne	gives
somnifère	sleeping pill
puissant	powerful
l'appelle	the calls
goutte	drop
vivant	living
pierre	stone
trouve	find
l'estomac	the stomach
chèvres	goats
constitue	is
antidote	antidote
plupart	most
poisons	poisons
s'agit	is
plante	plant
l'on	we
connaît	knows
d'aconit	of aconite
attendez	wait
note	note
bruissement	rustle
plumes	feathers
parchemins	scrolls
impertinence	impertinence
coûtera	cost
point	point
ajouta	added
répartit	distributes
fit	fit
préparer	prepare
potion	potion
destinée	for
soigner	treat
furoncles	boils
repassait	ironed
parmi	among
longue	long
cape	cape
noire	black
flottant	floating
regardant	looking at
peser	weigh
orties	nettles
séchées	dried
écraser	crush
crochets	hooks
serpent	snake
chacun	each
droit	right
sévères	severe
critiques	critical
sauf	except
semblait	seemed
éprouver	experience
sympathie	sympathy
brusquement	suddenly
nuage	cloud
fumée	smoke
verte	green
accompagné	accompanied
sifflement	whistle
sonore	sound
emplit	fills
neville	neville
londubat	londubat
débrouillé	managed
fondre	melt
seamus	seamus
répandait	spread
carrelage	tile
rongeant	gnawing
chaussures	shoes
instant	now
tard	later
debout	standing
tabourets	stools
aspergé	sprinkled
fondu	melted
gémissait	moaning
douleur	pain
poussaient	grew
bras	arm
jambes	legs
imbécile	fool
gronda	gronda
faisant	making
disparaître	disappear
geste	gesture
répandue	widespread
sol	soil
j'imagine	I guess
avez	have
ajouté	added
épines	thorns
porc-épic	porcupine
retirer	remove
feu	fire
pleurnichait	pleurnichait
emmenez-le	take the
l'infirmerie	the infirmary
ordonna	ordered
tourna	turned
préparé	prepared
pourquoi	why
avez-vous	have you
ajouter	add
suite	suite
pensiez	thought
s'il	if it
ratait	missed
auriez	would
brillant	brilliant
voilà	this is
va	will
coûter	cost
tellement	so
injuste	unfair
ouvrit	opened
bouche	mouth
répliquer	replicate
donna	donna
l'en	the
dissuader	deter
laisse	leaves
chuchota-t-il	whispered-t-he
paraît	seems
peut	can
devenir	become
méchant	nasty
s'y	there
met	puts
remontèrent	went
heure	time
remuait	stir-fried
sombres	dark
pensées	thoughts
moral	moral
bas	the bottom
perdre	lose
points	points
haïssait-il	hated it
t'en	you
fais	do
enlevait	removed
cause	cause
fred	fred
george	george
peux	can
toi	you
moins	less
cinq	five
quittèrent	left
traversèrent	crossed
parc	park
habitait	lived
maison	home
bois	wood
bordure	border
forêt	forest
arbalète	crossbow
paire	pair
bottes	boots
caoutchouc	rubber
posées	asked
frappa	hit
fracas	crash
retentit	sounds
l'intérieur	inside
d'aboiements	barking
sonores	sound
domina	domina
vacarme	din
Ça	It
suffit	just
crockdur	crockdur
va-t'en	go
visage	face
hirsute	shaggy
apparut	appeared
l'entrebâillement	round
s'efforçant	striving
retenir	remember
collier	necklace
énorme	huge
molosse	mastiff
noir	black
comportait	included
pièce	room
jambons	hams
faisans	pheasants
suspendus	suspended
bouilloire	kettle
cuivre	copper
posée	asked
coin	corner
occupé	busy
lit	bed
massif	massive
recouvert	covered
courtepointe	quilt
patchwork	patchwork
faites	do
lâchant	dropping
bondit	leaps
entreprit	undertook
lécher	lick
consciencieusement	conscientiously
oreilles	ears
féroce	fierce
paraissait	seemed
présente	this
versait	paid
l'eau	the water
chaude	hot
théière	teapot
disposait	had
biscuits	biscuits
assiette	plate
vois	see
remarqua	noticed
taches	spots
rousseur	freckles
j'ai	I
passé	past
moitié	half
ma	my
poursuivre	continue
tes	your
frères	brothers
prenait	took
l'envie	the desire
d'aller	go
tour	tour
faillirent	almost
casser	break
dents	teeth
firent	did
semblant	pretend
délicieux	delicious
racontèrent	told
bavait	dribbled
abondamment	plenty
robe	dress
furent	were
enchantés	enchanted
d'entendre	to hear
qualifier	qualify
ganache	ganache
jours	days
présenter	present
horrible	horrible
j'entre	I
suit	following
partout	everywhere
impossible	impossible
débarrasser	rid
d'elle	it
l'envoie	sends
raconta	told
réponse	response
aimé	loved
dirait	looks like
vraiment	really
hait	hates
insista	insisted
dis	say
bêtises	nonsense
assura	assura
te	te
haïrait-il	hated it
détourné	hijacked
disant	saying
cela	this
ton	your
frère	brother
charlie	charlie
l'aimais	the loved
savait	knew
prit	took
journal	journal
posé	asked
table	table
article	article
découpé	cut
gazette	gazette
cambriolage	burglary
gringott's	gringott's
l'enquête	the survey
produit	product
31	31
juillet	July
locaux	local
banque	bank
gringotts	gringotts
poursuit	continues
piste	track
enquêteurs	investigators
devrait	should
mener	lead
milieux	environments
gobelins	goblins
ont	have
répété	repeated
volé	stolen
chambre	room
fracturée	fractured
vidée	emptied
révélerons	reveal
propre	own
intérêt	interest
conseillons	advise
vivement	strongly
mêler	mix
affaire	case
déclaré	said
porte-parole	spokesperson
souvenait	remember
train	train
tentative	attempt
précisé	specified
date	date
laquelle	which
s'exclama	exclaimed
mon	my
anniversaire	anniversary
aurait	would
pu	could
n'y	there
aucun	no
fuyait	leaked
grognement	grunt
offrit	offered
biscuit	biscuit
relut	read
l'article	article
vidé	emptied
numéro	number
713	713
appeler	call
ça	it
vider	empty
paquet	package
enveloppé	wrapped
kraft	kraft
etait-ce	was this
voleurs	thieves
voulu	wanted
dérober	steal
revint	returned
poches	pockets
pleines	full
trop	too
polis	polished
refuser	refuse
estima	estima
qu'aucun	no
suivis	followed
donné	given
penser	think
fameux	famous
cherchaient	looking
emporté	away
posait	was
question	question
quelque	some
cacher	hide
sujet	about
l'antipathie	the antipathy
manifestée	manifested
