chapitre	chapter
12	12
le	the
miroir	mirror
du	the
riséd	riséd
noël	christmas
approchait	approaching
un	a
jour	day
de	of
la	the
mi-décembre	in mid-December
poudlard	hogwarts
se	is
réveilla	woke up
sous	under
une	a
épaisse	thick
couche	layer
neige	snow
lac	lake
avait	had
gelé	frozen
et	and
les	the
jumeaux	twins
weasley	weasley
reçurent	received
punition	punishment
pour	for
avoir	have
fabriqué	manufactured
des	of
boules	balls
magiques	magic
qui	that
suivaient	followed
quirrell	quirrell
partout	everywhere
où	where
il	it
allait	would
en	in
visant	aimed
son	its
turban	turban
hagrid	hagrid
s'occupait	was
soigner	treat
quelques	a few
hiboux	owls
arrivaient	arrived
à	to
traverser	cross
l'air	the air
glacé	glossy
apporter	bring
courrier	mail
frigorifiés	refrigerated
tout	all
monde	world
attendait	waiting
vacances	holiday
avec	with
impatience	impatience
feux	lights
cheminée	fireplace
chauffaient	heated
grande	great
salle	room
commune	common
gryffondor	gryffindor
mais	but
couloirs	corridors
étaient	were
parcourus	driven
courants	common
d'air	air
glacés	icy
vent	wind
polaire	polar
faisait	was
trembler	shake
fenêtres	windows
salles	rooms
classe	class
pire	worst
c'était	it was
cours	during
professeur	professor
rogue	rogue
dans	in
cachot	dungeon
glacial	icy
élèves	students
serraient	shake
contre	against
chaudrons	pots
essayer	try
protéger	protect
froid	cold
je	I
plains	plains
beaucoup	a lot
malheureux	unhappy
devront	will have to
rester	stay
pendant	during
parce	because
que	that
personne	person
n'en	do
veut	wants to
maison	home
lança	launched
malefoy	malfoy
potions	potions
dit	said
cela	this
regardant	looking at
harry	harry
crabbe	crabbe
goyle	goyle
pouffèrent	pouffèrent
rire	laugh
n'y	there
prêta	lent
aucune	no
attention	attention
été	been
plus	more
désagréable	unpleasant
jamais	never
depuis	since
match	match
quidditch	quidditch
dégoûté	disgusted
par	by
défaite	defeat
serpentard	slytherin
essayé	tried
mettre	put
rieurs	laughing
côté	side
répétant	repeating
prochaine	next
fois	time
on	it
pourrait	could
remplacer	replace
crocodile	crocodile
train	train
bâiller	yawn
s'était	had
très	very
vite	fast
rendu	rendering
compte	account
sa	its
plaisanterie	joke
n'amusait	not amused
car	because
impressionné	impressed
virtuosité	virtuosity
laquelle	which
réussi	successful
s'accrocher	hang on
balai	broom
jaloux	jealous
furieux	furious
consolait	consoled
saisissant	entering
toutes	all
occasions	opportunities
rappeler	remember
n'avait	had
pas	not
famille	family
digne	worthy
ce	this
nom	name
effet	effect
n'irait	there would be a
privet	privet
drive	drive
mcgonagall	mcgonagall
était	was
passée	past
classes	classes
semaine	week
précédente	previous
faire	do
liste	list
resteraient	would
premier	first
s'inscrire	register
éprouvait	felt
aucun	no
regret	regret
au	the
contraire	contrary
probablement	probably
connaître	know
meilleur	best
vie	life
ron	ron
ses	its
frères	brothers
passeraient	would
également	also
leurs	their
collège	college
mr	mr
mrs	mrs
devaient	had to
rendre	make
roumanie	romania
aller	go
voir	see
leur	their
fils	son
charlie	charlie
lorsqu'ils	when they
sortirent	went out
énorme	huge
sapin	fir
avançait	advanced
couloir	hallway
haletant	panting
soufflant	blowing
ahanant	labouring
deux	two
pieds	feet
immenses	huge
qu'on	we
voyait	saw
dépasser	exceed
trahissaient	betrayed
présence	presence
derrière	behind
vous	you
avez	have
besoin	need
d'aide	help
demanda	asked
passant	from
tête	head
parmi	among
branchages	branches
non	not
ça	it
va	will
merci	thank you
pourriez	could
dégager	release
chemin	path
eux	them
voix	voice
sèche	dry
tu	you
essayes	try
te	te
peu	little
d'argent	money
poche	pocket
vises	referred to
place	place
garde-chasse	gamekeeper
quand	when
sortiras	get out
c'est	it is
vrai	true
quelqu'un	someone
ta	your
cabane	hut
doit	must
d'un	a
palace	palace
rua	rua
sur	on
moment	time
même	even
montait	rose
l'escalier	the stairs
lâcha	released
a	has
provoqué	caused
montrant	showing
grosse	big
hirsute	shaggy
insulté	insulted
possible	possible
est	is
interdit	prohibited
battre	beat
répliqua	replied
ton	your
doucereux	sugary
cinq	five
points	points
moins	less
estimez-vous	do you feel you
heureux	happy
ne	do
soit	either
davantage	more
allez	go
filez	filez
maintenant	now
ricanement	sneer
avancèrent	forth
repoussant	pushing
répandit	spread
aiguilles	needles
sol	soil
l'aurai	the will
entre	between
dents	teeth
ces	these
jours	days
déteste	hate
deux-là	two
ajouta	added
allons	will
gaieté	gaiety
bientôt	soon
venez	come
moi	me
merveille	wonder
tous	all
trois	three
suivirent	followed
arbre	tree
jusqu'à	up to
flitwick	flitwick
s'affairaient	busy
installer	install
décorations	decorations
ah	ah
dernier	last
mettez-le	put the
bout	end
là-bas	there
s'il	if it
plaît	please
magnifique	beautiful
guirlandes	garlands
gui	gui
houx	holly
suspendues	suspended
aux	the
murs	walls
d'une	a
douzaine	dozen
d'arbres	trees
dressaient	up
autour	around
certains	some
recouverts	covered
glaçons	ice cubes
scintillants	sparkling
d'autres	other
chandelles	candles
allumées	lit
reste	rest
combien	how
avant	before
seul	only
répondit	replied
hermione	hermione
fait	fact
nous	we
avons	have
encore	yet
demi-heure	a half-hour
déjeuner	breakfast
devrions	should
bibliothèque	library
as	as
raison	reason
s'arrachant	tearing
contemplation	contemplation
apparaître	appear
baguette	wand
magique	magic
d'or	gold
qu'il	it
accrochait	hung
branches	branches
nouveau	new
suivant	following
hall	hall
juste	just
êtes	are
vraiment	really
passionnés	passionate
oh	oh
n'est	there is
travailler	work
joyeux	happy
parlé	spoken
nicolas	nicolas
flamel	flamel
essaye	try
savoir	know
quoi	what
s'exclama	exclaimed
interloqué	nonplussed
ecoutez-moi	listen to me
ai	I
laisser	let
tomber	fall
chien	dog
garde	guard
votre	your
affaire	case
simplement	simply
vouliez	want to
dire	say
vous-même	you
épargner	save
recherches	research
déjà	already
consulté	consulted
centaines	hundreds
livres	books
n'avons	have
rien	nothing
trouvé	found
pourtant	yet
suis	am
sûr	course
d'avoir	to have
lu	read
quelque	some
part	share
dirai	tell
cas	case
cherchera	will
seuls	only
ils	they
filèrent	spinning
vers	to
tandis	while
regardait	watched
air	air
mécontent	unhappy
indice	index
dont	which
disposaient	had
découvrir	discover
voulait	wanted
voler	fly
l'instant	the moment
n'avaient	had
trace	trace
personnage	character
dizaines	tens
d'ouvrages	books
consultés	consulted
savaient	knew
bien	well
commencer	start
ignoraient	did not know
figurer	be
livre	book
n'était	there was
grands	great
sorciers	wizards
xx	xx
e	e
siècle	century
ni	or
noms	names
célèbres	famous
contemporain	contemporary
grandes	large
découvertes	discoveries
etude	study
récents	recent
progrès	progress
sorcellerie	witchcraft
restait	remained
milliers	thousands
étagères	shelves
feuilleter	browse
volumes	volumes
représentait	represented
tâche	task
immense	huge
renoncé	waived
autant	as much
étudia	studied
titres	securities
thèmes	themes
pouvaient	could
allusion	hint
promenait	walking
long	long
prenant	taking
hasard	random
lui	him
aventuré	ventured
réserve	reserve
fallait	had to
mot	word
l'un	one
professeurs	teachers
accès	access
ouvrages	books
y	there
conservait	retained
savait	knew
n'obtiendrait	would
telle	such
autorisation	authorization
traitaient	treated
magie	magic
noire	black
matière	material
enseignée	taught
étudiants	students
dernière	last
année	year
faisaient	were
poussées	flare-ups
défense	defence
forces	forces
mal	evil
consulter	consult
qu'est-ce	what is this
cherches	are looking for
mon	my
garçon	boy
madame	mrs.
pince	clamp
bibliothécaire	librarian
menaça	threatened
plumeau	feather duster
ferais	would
mieux	better
filer	spinning
dehors	outside
n'ayant	having
prétexte	excuse
plausible	plausible
justifier	justify
résigna	resigned
quitter	leave
avaient	had
décidé	decided
valait	worth
demander	ask
pourraient	could
dénicher	find
renseignements	information
voulaient	wanted
prendre	take
risque	risk
découvre	discover
qu'ils	they
cherchaient	looking
resta	remained
attendant	waiting
autres	other
trouvent	find
chose	thing
d'espoir	hope
duré	lasted
quinze	fifteen
comme	as
pu	could
consacrer	devote
moments	moments
par-ci	here
par-là	there
surprenant	surprising
aient	have
chou	cabbage
blanc	white
auraient	would
eu	had
longtemps	for a long time
sans	without
continuellement	continually
dos	back
minutes	minutes
tard	later
rejoignirent	joined
faisant	making
allèrent	went
continuerez	continue
chercher	search
serai	am
là	there
hein	eh
si	if
trouvez	find
envoyez-moi	send me
suite	suite
hibou	owl
pourrais	could
tes	your
parents	parents
s'ils	if they
savent	know
suggéra	suggested
risques	risks
assura	assura
sont	are
dentistes	dentists
lorsque	when
commencèrent	started
eurent	had
trop	too
d'occasions	opportunities
s'amuser	have fun
penser	think
dortoir	dormitory
rassemblait	together
grand	great
permettait	allowed
s'installer	install
meilleurs	best
fauteuils	chairs
près	near
feu	fire
restaient	remained
assis	sitting
heures	hours
entières	whole
manger	eat
trouvaient	were
cuire	cook
broche	pin
pain	bread
pancakes	pancakes
marshmallows	marshmallows
échafaudant	échafaudant
stratégies	strategies
renvoyer	return
l'école	the school
plans	plans
doute	doubt
irréalisables	impossible
toujours	always
amusant	fun
d'en	to
parler	talk
apprit	learned
jeu	game
d'échecs	chess
version	version
sorcier	sorcerer
règles	rules
mêmes	same
chez	in
moldus	muggle
sauf	except
pièces	parts
vivantes	living
donnait	gave
armée	army
partant	hence
bataille	battle
l'échiquier	the chessboard
vieux	old
abîmé	damaged
affaires	business
appartenu	belonged
autre	other
membre	member
grand-père	grand-father
l'occurrence	the occurrence
l'âge	the age
cependant	however
constituait	was
plutôt	rather
avantage	advantage
temps	time
fréquentait	consorted
connaissait	knew
revanche	contrast
jouait	played
seamus	seamus
finnigan	finnigan
prêtées	lent
confiance	trust
jouer	play
contestaient	challenged
cesse	stops
décisions	decisions
jetait	cast
confusion	confusion
m'envoie	sends me
disait	said
fou	crazy
ou	or
tour	tour
n'as	did
donc	so
vu	seen
cavalier	jumper
tiens	want
envoie	sends
celui-là	this one
peut	can
permettre	allow
perdre	lose
veille	eve
coucha	lay down
pensant	thinking
lendemain	next day
serait	would be
bonne	good
journée	day
aurait	would
réveillon	new year's eve
s'attendait	expected
recevoir	receive
cadeaux	gifts
lorsqu'il	when it
s'éveilla	woke
aperçut	saw
petit	small
tas	heap
paquets	packages
pied	foot
lit	bed
ensommeillée	ensommeillée
s'extrayait	is extracted
passait	passed
robe	dress
chambre	room
toi	you
aussi	also
rends	give
j'ai	I
ouvrit	opened
aussitôt	as soon
paquet	package
trouvait	was
sommet	summit
pile	battery
enveloppé	wrapped
gros	wholesale
papier	paper
lequel	which
griffonné	scribbled
l'intérieur	inside
flûte	flute
bois	wood
grossièrement	coarsely
taillée	cut
toute	any
évidence	obviously
lui-même	himself
l'avait	had
fabriquée	manufactured
souffla	blew
dedans	in
elle	it
produisit	produced
semblable	similar
ululement	ululement
contenait	contained
simple	simple
reçu	received
message	message
voici	here
cadeau	gift
l'oncle	uncle
vernon	vernon
tante	aunt
pétunia	petunia
pièce	room
cinquante	fifty
pence	pence
collée	stuck
l'aide	using
morceau	song
ruban	ribbon
adhésif	adhesive
gentil	nice
fasciné	fascinated
monnaie	currency
bizarre	weird
dit-il	he said
quelle	what
drôle	funny
forme	form
l'argent	the money
prends-la	take the
veux	want to
m'a	me
envoyé	sent
crois	believe
d'où	where
vient	comes
rougissant	blushing
ma	my
mère	mother
avais	had
n'attendais	did not expect
t'a	you
pull	pull
mode	mode
sortit	went out
épais	thick
pull-over	pull-over
laine	wool
vert	green
émeraude	emerald
tricoté	knitted
boîte	box
fondants	fluxes
faits	facts
ans	years
tricote	knits
chacun	each
déballant	unpacking
sien	his
mien	mine
violet	purple
goûtant	tasting
fondant	based
révéla	revealed
délicieux	delicious
friandises	treats
chocogrenouilles	chocolate frog
qu'hermione	as hermione
envoyée	sent
qu'un	a
ouvrir	open
déchira	rent
tissu	fabric
léger	lightweight
teinte	hue
argentée	silver
glissa	slipped
forma	forma
reflets	reflections
luisants	shiny
bouche	mouth
bée	eer
entendu	heard
sourde	deaf
existe	there is
précieux	precious
ramassa	picked up
brillant	brilliant
doigts	fingers
eut	had
l'impression	printing
toucher	touch
l'eau	the water
transformée	transformed
étoffe	fabric
cape	cape
d'invisibilité	invisibility
j'en	I
essaye-la	try-the
jeta	threw
épaules	shoulders
poussa	pushed
cri	cry
regarde	look at
regarda	looked at
disparu	gone
précipita	rushed
vit	lives
visage	face
semblait	seemed
flotter	float
corps	body
devenu	now
invisible	invisible
remonta	came up
reflet	reflection
s'effaça	vanished
complètement	completely
soudain	suddenly
enleva	removed
lut	lut
écrit	written
écriture	writing
arrondie	rounded
vue	view
auparavant	previously
père	father
laisse	leaves
ceci	this
mourir	die
hérites	hérites
fais-en	make
bon	good
usage	use
signature	signature
garda	garda
yeux	eyes
fixés	set
contemplait	contemplated
admiratif	admiring
serais	would be
prêt	loan
donner	give
n'importe	any
eh	eh
ben	ben
t'arrive	you can
étrange	strange
sensation	sensation
envoyer	send
cette	this
avait-elle	had she
véritablement	truly
tellement	so
voulu	wanted
réponse	response
questions	questions
ait	has
d'autre	on the other
porte	door
s'ouvrit	opened
volée	fly
fred	fred
george	george
précipitèrent	ran
hâta	haste
cacher	hide
envie	want
partager	share
secret	secret
quiconque	anyone
hé	hey
vêtus	dressed
bleu	blue
portait	wore
f	f
poitrine	chest
l'autre	the other
g	g
celui	the
beau	beautiful
nôtres	ours
examinant	examining
apparemment	apparently
d'efforts	efforts
pourquoi	why
n'as-tu	have you
mis	put
tien	tien
vas-y	vas-y
mets-le	put the
verras	see
agréable	nice
horreur	horror
marmonna	muttered
mettant	putting
lettre	letter
fît	cause
remarquer	notice
n'oublies	do not forget
idiots	idiots
sait	knows
s'appelle	is called
gred	gred
forge	forge
bruit	noise
percy	percy
passa	spent
l'entrebâillement	round
réprobateur	réprobateur
commencé	started
déballer	unpack
bras	arm
s'empara	seized
p	p
préfet	prefect
je-ne-veux-pas-le	I-don't-want-not-the
protesta	protested
l'obligeaient	the forced
enfiler	thread
moitié	half
lunettes	glasses
n'es	no es
préfets	prefects
aujourd'hui	today
fête	feast
traînèrent	dragged
alors	then
hors	out
immobilisés	fixed
passé	past
dindes	turkeys
rôties	roasted
saucisses	sausages
grillées	grilled
sauces	sauces
onctueuses	creamy
confiture	jam
d'airelles	blueberry
tables	tables
pochettes-surprises	pockets-surprises
pétards	firecrackers
explosaient	exploded
jaillir	squirt
surprises	surprises
ceux	those
dursley	dursley
l'habitude	the usual
d'acheter	buy
n'étaient	there were
remplis	filled
petits	small
jouets	toys
plastique	plastic
chapeaux	hats
crépon	crépon
partagea	shared
contenta	contenta
produire	produce
petite	small
détonation	detonation
explosa	exploded
canon	canon
enveloppant	wrapping
nuage	cloud
fumée	smoke
bleue	blue
chapeau	hat
contre-amiral	rear-admiral
ainsi	as well
plusieurs	several
souris	mouse
blanches	white
bûches	logs
pudding	pudding
faillit	almost
casser	break
dent	tooth
trouvant	finding
mornille	mornille
argent	money
dumbledore	dumbledore
troqué	swapped
pointu	sharp
bonnet	bonnet
fleurs	flowers
pochette-	cover-
surprise	surprise
riait	laughed
écoutant	listening to
raconter	tell
histoire	history
teint	complexion
rouge	red
réclama	asked
nouvelle	new
bouteille	bottle
vin	wine
puis	then
embrassa	kissed
joue	plays
gloussa	chuckled
contentement	contentment
joues	cheeks
écarlates	scarlet
travers	through
quitta	left
table	table
encombrés	congested
découverts	discovered
notamment	in particular
ballons	balloons
lumineux	bright
increvables	puncture-proof
kit	kit
pousser	push
verrues	warts
impression	print
qu'elles	they
servi	served
dîner	dinner
miss	miss
teigne	ringworm
passèrent	passed
l'après-midi	in the afternoon
batailles	battles
parc	park
mouillés	wet
essoufflés	out of breath
retournèrent	returned
auprès	with
devant	before
étrenna	étrenna
plate	flat
couture	couture
songea	songea
n'aurait	would
perdu	lost
facilement	easily
acharné	hard
l'aider	the help
ensuite	then
thé	tea
accompagné	accompanied
sandwiches	sandwiches
dinde	turkey
pains	bread
gâteaux	cakes
somnolents	sleepy
ventre	belly
plein	full
regardèrent	looked
lancer	launch
poursuite	further
récupérer	recover
insigne	badge
volé	stolen
amusé	amused
cessé	stopped
tourner	turn
mystérieux	mysterious
expéditeur	sender
rôtie	roasted
libre	free
préoccupation	concern
tomba	fell
endormi	asleep
dès	as soon
tiré	shot
rideaux	curtains
baldaquin	canopy
pencha	bent
cachée	hidden
douce	soft
soie	silk
légère	light
souffle	breath
l'étoffe	the fabric
coulait	flowed
ruisseau	creek
était-il	was it
l'essayer	try it
s'enveloppa	wrapped herself
ombres	shadows
tache	spot
rayon	radius
lune	moon
sentit	felt
parfaitement	perfectly
réveillé	woke up
grâce	thanks
château	castle
entier	integer
ouvert	open
debout	standing
l'obscurité	the dark
silence	silence
éprouva	felt
sentiment	feeling
d'excitation	excitation
pouvait	could
présent	this
rusard	rusard
saurait	not
grogna	" 
sommeil	sleep
fallait-il	was it
réveiller	wake up
l'en	the
empêcha	prevented
première	first
être	be
descendit	went down
traversa	crossed
trou	hole
dissimulait	hid
portrait	portrait
couina	couina
dame	lady
s'arrêta	stopped
réfléchit	thinking
cœur	heart
battant	flying
l'idée	the idea
vint	came
lire	read
voudrait	would like to
passer	pass
faudrait	should
mit	mit
serrant	tightening
plongée	diving
ténèbres	darkness
régnait	reigned
atmosphère	atmosphere
effrayante	scary
alluma	lit
lampe	lamp
flottait	floated
poids	weight
lueur	glow
promener	walk
seule	only
fit	fit
peur	fear
fond	background
enjamba	stepped over
précaution	caution
cordon	cord
séparait	separated
interdits	banned
tendit	handed
alignés	aligned
disaient	said
grand-chose	much
lettres	letters
dorées	golden
ternies	tarnished
usées	waste
formaient	formed
mots	words
comprenait	included
titre	title
maculé	dirty
sombre	dark
l'horrible	the horrible
d'être	to be
sang	blood
cheveux	hair
dresser	draw
nuque	neck
peut-être	maybe
imagination	imagination
jouait-elle	played it
tours	towers
peut-	can-
crut	believed
entendre	hear
faible	low
chuchotement	whisper
provenait	came
rangées	rows
dû	due
posant	posing
terre	earth
s'intéressa	if interested
l'étagère	the shelf
bas	the bottom
volume	volume
noir	black
attira	drew
regard	look
lourd	heavy
équilibre	balance
genoux	knees
hurlement	howl
suraigu	hyperacute
glacer	icing
retentit	sounds
criait	shouted
referma	closed
coup	blow
sec	dry
continua	continued
note	note
assourdissante	deafening
arrière	rear
renversant	reversing
s'éteignit	died
instantanément	instantly
saisi	seized
panique	panic
entendit	heard
bruits	noise
résonnaient	resounded
remit	gave
tant	as
prit	took
fuite	leak
jambes	legs
retrouva	found
face	in the face of
celui-ci	it
arrivait	arrived
l'entrée	the entry
pâles	pale
gardien	guardian
parvint	managed
faufiler	sneak
mur	wall
fonça	rushed
résonnait	sounded
oreilles	ears
perçant	piercing
haute	high
armure	armor
occupé	busy
distance	distance
direction	management
prise	outlet
cause	cause
incapable	unable
reconnaître	recognize
l'endroit	the place
m'avez	I have
demandé	asked
avertir	warn
directement	directly
venait	came
rôder	prowl
nuit	night
précisément	precisely
pâlir	fade
devait	should
raccourci	shortcut
grasseyante	grasseyante
rapprochait	close
terreur	terror
répondre	reply
n'ont	have
loin	far
rattraper	catch up
figé	frozen
s'avançaient	advanced
étroit	close
allaient	would
inévitablement	inevitably
heurter	face
passage	passage
rendait	made
supprimait	removed
recula	backed
gauche	left
entrouverte	ajar
retenant	retaining
respiration	breathing
essayant	trying
bouger	move
panneau	panel
soulagement	relief
entrer	enter
l'insu	the blind
s'arrêter	stop
s'adossa	if adossa
respirant	breathable
profondément	deeply
s'éloigner	away
s'évanouir	vanish
chaud	hot
instants	moments
jette	throws
d'œil	eye
désaffectée	disused
pupitres	keyboards
chaises	chairs
entasses	entasses
corbeille	trash
papiers	papers
retournée	returned
remarqua	noticed
appuyé	supported
appartenir	belong
mobilier	furniture
habituel	usual
ranger	ranger
s'en	in
débarrasser	rid
jusqu'au	until the
plafond	ceiling
cadre	framework
sculpté	carved
posé	asked
pourvus	filled
griffes	claws
pattes	legs
d'animal	animal
inscription	registration
gravée	engraved
au-dessus	above
déchiffra	deciphered
elrue	elrue
ocnot	ocnot
edsi	edsi
amega	amega
siv	siv
notsap	notsap
ert	ert
nomen	nomen
ej	ej
n'entendait	did
calmée	calmed down
ôta	took off
s'approcha	approached
vérifier	check
dut	otc
plaquer	tackle
main	hand
étouffer	choke
d'horreur	horror
retourna	returned
brusquement	suddenly
cogna	knocked
fort	fort
hurler	scream
apparu	appeared
groupe	group
gens	people
tenaient	held
vide	empty
haletante	panting
tourna	turned
lentement	slowly
livide	livid
apeuré	frightened
dix	ten
personnes	people
par-dessus	above
épaule	shoulder
invisibles	invisible
faculté	faculty
refléter	reflect
femme	woman
souriait	smiling
signes	signs
présente	this
n'existaient	there were
belle	beautiful
auburn	auburn
miens	mine
pensa	thought
s'approchant	approaching
glace	ice
ii	ii
s'aperçut	saw
pleurait	crying
l'homme	the man
tenait	held
d'elle	it
mince	thin
noirs	black
coiffés	styled
épis	ears
dépassaient	exceeded
l'arrière	the rear
crâne	skull
nez	nose
touchait	touched
presque	almost
maman	mom
murmura-t-il	he murmured
papa	dad
souriant	smiling
détailla	detailed
verts	green
siens	his
ressemblaient	looked like
vieille	old
noueux	knotty
potter	potter
souriaient	smiling at her
adressaient	directed
fébrile	febrile
mains	hands
plaquées	plated
espérait	hoped
précipiter	rush
mélange	mix
joie	joy
tristesse	sadness
s'effaçaient	deferred
lassait	tired
regarder	watch
lointain	distant
ramène	back
réalité	reality
ici	here
retrouve	found
arracha	tore
murmura	whispered
reviendrai	will come back
aurais	would have
me	me
mauvaise	bad
humeur	mood
qu'à	as
venu	come
soir	evening
j'y	I
retourne	returns
montrer	show
j'aimerais	I would like to
complet	complete
pourras	can
peux	can
suffira	suffice
venir	come
cet	this
d'ailleurs	moreover,
montre	watch
morts	dead
dommage	damage
n'aies	hast
trouver	find
oublié	forgot
pensait	thought
revoir	review
importait	importance
désormais	now
têtes	heads
gardait	kept
Ça	It
s'inquiéta	if worry
craignait	feared
capable	able
retrouver	find
s'étaient	had
enveloppés	wrapped
déplacer	move
essayèrent	tried
refaire	redo
suivi	follow-up
fuyant	fleeing
errèrent	wandered
heure	time
alentour	around
gèle	freezes
laissons	let
chuchota	whispered
instant	now
reconnut	recognized
oui	yes
poussèrent	pushed
débarrassa	rid
courut	ran
semblèrent	seemed
rayonner	shine
voyant	light
vois	see
mets-toi	put yourself
plaça	plaça
sembla	seemed
propre	own
regarde-moi	look at me
s'exclama-t-il	exclaimed,-t-he
changé	changed
chef	chief
qu'avait	that was
frère	brother
bill	bill
mes	my
coupe	cup
capitaine	captain
l'équipe	the team
s'arracha	tore itself away
l'avenir	the future
impossible	impossible
morte	dead
laisse-moi	let me
l'as	the ace
fais	do
tenir	take
passionnant	exciting
important	important
arrête	stop
provenance	from
fin	end
discussion	discussion
parlaient	spoke
ramena	brought back
étincelants	sparkling
apparaissaient	appeared
restèrent	stayed
immobiles	still
ayant	having
pensée	thought
est-ce	is this
marchait	walked
chats	cats
parut	appeared
interminable	endless
s'éloigna	walked away
enfin	finally
méfions-nous	let us beware
allée	alley
qu'elle	it
entendus	heard
viens	just
tira	drew
matin	morning
fondu	melted
partie	part
proposa	proposed
sais	know
penses	think
risqué	risky
n'arrêtent	do not stop
voient	see
risquez	may
finiras	will
s'apercevront	will find
dirait	looks like
observer	observe
qu'une	a
idée	idea
retourner	return
certainement	certainly
empêcher	prevent
troisième	third
mauvaises	bad
rencontres	meetings
grands-pères	grandfathers
hochait	swung
expression	expression
bonheur	happiness
s'assit	sat
l'empêchait	the prevented
contempler	contemplate
es	es
bureau	office
albus	albus
monsieur	mr.
balbutia	stammered
l'invisibilité	the invisibility
rend	makes
myope	short-sighted
fut	was
soulagé	relieved
s'asseoir	sit
découvert	discovered
savais	knew
l'appelait	the called
j'imagine	I guess
compris	including
ami	friend
comment	how
savez-vous	do you know
n'ai	haven
devenir	become
comprends	understand
vais	'll
t'expliquer	explain
ordinaire	ordinary
verrait	would
t'aide	to help you
comprendre	understand
voulons	want to
désir	desire
profond	deep
cher	dear
ayons	have
notre	our
connu	known
ronald	ronald
vécu	lived
l'ombre	the shadow
s'est	is
couvert	covered
gloire	glory
d'honneurs	honors
connaissance	knowledge
vérité	truth
hommes	men
ont	have
dépéri	wasted away
devenus	become
fous	crazy
contemplant	contemplating
voyaient	saw
montrait	showed
réel	real
demain	tomorrow
sera	will be
déménagé	moved
ailleurs	elsewhere
demande	request
dessus	top
seras	will be
averti	warned
rêves	dreams
oubliant	forgetting
vivre	live
souviens-toi	remember
remets	put
merveilleuse	wonderful
coucher	bedroom
releva	rose
recommencer	again
voyez	see
regardez	watch
paire	pair
chaussettes	socks
ébahis	amazed
manque	lack
s'obstinent	sticks
m'offrir	offer me
rejoint	joined
répondu	answered
après	after
question	question
personnelle	personal
